99 99 99 99 99 99 99 99 99 99 99 99 99 99 99 99 99 99 99 99 99 99 99 99 99 99 99 99 99 99 99 99 99 99 99 99 99 99 99 99 99 77 78 78 99 78 78
99 99 99 99 99 99 99 99 99 99 99 99 99 99 99 99 99 99 99 99 99 99 99 99 99 99 99 99 99 99 99 99 99 99 99 99 78 99 99 99 99 77 70 72 70 72 70 77 99 99 78
99 99 99 99 99 99 99 99 99 99 99 99 99 99 99 99 99 99 99 99 99 99 99 99 99 99 99 99 99 99 99 99 99 99 99 99 99 99 99 99 78 77 72 70 72 70 72 77 
99 99 99 99 99 99 99 99 99 99 99 99 99 99 99 99 99 99 99 99 99 99 99 99 99 99 99 99 99 99 99 99 99 99 99 99 99 99 78 99 99 77 70 72 70 72 70 77 77 99 99 99 99 77 77 77 77 99 99 99 78
99 99 99 99 99 99 99 99 99 99 99 99 78 99 99 99 99 99 99 99 99 99 99 99 99 99 99 99 99 99 99 99 99 99 99 99 99 99 99 99 77 77 72 70 72 70 72 78 78 78 78 78 78 78 78 78 78 78 77
99 99 99 99 99 99 99 99 99 99 99 99 99 99 99 99 99 99 99 99 99 78 77 99 99 99 99 99 99 99 99 99 99 78 78 99 99 99 99 99 78 77 70 72 70 72 70 72 70 72 70 72 70 72 70 72 70 72 77 
99 99 99 99 99 99 78 78 99 99 99 77 77 77 99 99 99 99 99 99 99 99 78 99 99 99 99 99 99 78 99 99 99 99 99 99 99 99 99 99 99 77 72 70 72 70 72 70 72 70 72 70 72 70 72 70 72 70 77 77
99 99 99 99 99 99 99 99 99 99 77 78 78 78 78 77 99 78 99 99 99 99 99 99 99 99 99 99 99 99 99 99 77 77 77 77 77 77 99 99 99 78 70 72 70 72 70 78 78 77 70 72 70 72 70 72 70 72 77 77 99 77
99 99 99 78 77 99 99 77 78 77 77 70 72 70 72 77 99 99 99 99 77 77 99 99 99 99 78 99 77 78 78 78 78 78 78 78 78 78 78 99 99 99 78 78 72 70 77 99 99 77 72 70 72 70 72 70 72 70 77 78 99 78
99 99 77 99 78 78 78 78 99 77 77 72 70 72 70 77 99 77 77 78 78 78 78 78 78 77 99 99 77 72 70 72 70 72 70 72 70 72 70 77 99 99 99 99 70 72 77 99 99 77 70 72 70 72 70 72 70 72 77 99 99 99 99 99 99 99 99 78 77
99 78 77 70 72 70 72 70 72 78 78 70 72 70 72 78 78 78 78 70 72 70 72 70 72 78 78 99 78 70 72 70 72 70 72 70 72 70 72 77 99 99 77 77 72 70 77 77 99 77 77 78 78 77 72 70 72 77 78 99 99 99 99 99 99 99 99 99 78 99 99 99 78
99 99 77 72 70 72 70 72 70 72 70 72 70 72 70 72 70 72 70 72 70 72 70 72 70 72 70 72 70 72 70 72 70 72 70 72 70 72 70 77 99 78 78 78 70 72 78 78 77 77 78 99 99 77 70 72 70 77 99 99 99 77
99 99 78 70 72 70 72 70 72 70 72 70 72 70 72 70 72 70 72 70 72 70 72 70 72 70 72 70 72 70 72 70 72 70 72 70 72 70 72 77 77 70 72 70 72 70 72 70 77 77 99 99 99 77 72 70 72 77 99 99 99 77 99 99 99 99 99 99 99 99 78 99 99 99 78
99 99 99 72 70 72 70 72 70 77 77 72 70 72 70 78 78 99 77 72 70 72 70 72 70 77 77 78 78 72 70 72 70 72 70 72 70 72 70 77 77 72 70 72 70 72 70 72 77 78 99 99 99 77 70 72 70 77 77 99 99 78 99 99 77 78 99 99 99 99 70 72 70 72 99
99 78 99 70 72 70 72 70 72 77 77 77 77 77 77 99 99 99 77 70 72 70 72 70 72 77 78 99 99 70 72 70 72 70 72 70 72 70 72 77 77 70 72 70 72 70 72 70 77 99 99 77 99 78 72 70 72 77 77 99 99 99 99 99 78 70 72 70 72 70 72 70 72 70 99 
99 99 99 72 70 72 70 72 70 77 77 77 78 78 78 78 78 99 78 72 70 72 70 72 70 78 99 99 77 72 70 72 70 72 70 72 70 72 70 77 77 72 70 72 70 72 70 72 78 99 99 78 99 99 70 72 70 77 77 99 99 99 77 72 70 72 70 72 70 72 70 72 70 72 70 99
99 99 77 70 72 70 72 70 72 78 78 78 72 70 72 70 72 99 99 70 72 70 72 70 72 99 99 99 78 78 78 78 78 78 99 78 78 70 78 78 77 70 72 70 72 70 72 70 99 99 99 99 99 77 72 70 72 77 77 99 99 99 77 70 72 70 77 77 72 70 72 70 72 70 72 99  
78 99 77 72 70 72 70 72 70 72 70 72 70 72 70 72 70 78 99 72 70 72 70 72 70 77 99 99 99 99 99 99 99 99 99 99 99 72 99 99 77 72 70 72 70 72 70 72 77 99 99 99 77 77 70 72 70 77 77 99 99 77 77 72 70 72 78 78 70 72 70 72 77 77 70 99 78 
99 99 78 70 72 70 72 70 72 70 72 70 72 70 72 70 72 70 72 70 72 70 72 70 72 77 99 99 77 78 99 99 78 78 99 99 99 70 99 99 77 70 72 70 72 70 72 70 77 77 99 99 77 77 72 70 72 78 78 78 78 78 78 70 72 70 72 70 72 70 72 70 78 78 72 70 99
99 99 99 72 70 72 70 72 70 78 78 77 70 72 70 72 70 72 70 72 70 72 70 72 70 77 99 99 78 99 99 99 99 99 99 99 70 72 70 99 78 72 70 72 70 72 70 72 77 77 99 99 78 77 70 72 70 72 70 72 70 72 70 72 70 72 70 72 70 72 70 72 70 72 70 72 99
99 99 99 78 78 99 78 78 78 99 99 77 72 70 72 70 72 77 77 70 72 70 72 70 72 77 99 77 99 99 99 99 77 99 99 99 72 70 72 70 72 70 72 70 72 70 72 70 77 78 99 99 99 77 72 70 72 70 72 70 72 70 72 70 72 70 72 70 72 70 72 70 72 70 72 70 99
99 99 99 99 99 99 99 99 99 99 99 77 70 72 70 72 70 77 77 77 77 77 77 77 78 78 78 78 99 99 78 78 78 99 99 99 70 72 70 99 99 72 70 72 70 72 70 72 77 99 99 99 99 78 70 72 70 72 70 72 70 72 70 72 70 72 70 72 70 72 70 72 70 72 70 72 99 78  
99 99 99 99 78 99 99 78 77 99 99 77 72 70 72 70 72 77 77 77 77 77 77 77 72 70 72 70 72 70 72 70 72 70 99 99 99 70 99 99 78 70 72 70 72 70 72 70 77 99 99 99 99 99 78 78 78 77 77 77 77 78 77 70 72 70 72 70 72 70 72 70 72 70 72 99
99 99 99 99 99 99 99 99 78 99 99 77 70 72 70 72 70 77 78 78 78 78 77 77 70 72 70 72 70 72 70 72 70 72 70 72 70 72 99 99 99 77 77 78 78 77 77 78 77 77 77 77 99 99 99 99 99 78 78 78 78 99 77 72 70 72 70 72 70 72 70 72 70 72 70 99 
99 99 99 99 99 99 99 99 99 99 78 77 72 70 72 70 72 78 72 70 72 70 77 77 72 70 72 70 72 70 72 70 72 70 77 99 99 70 99 99 99 77 77 99 99 77 77 99 77 78 78 78 78 78 99 99 99 99 99 99 99 99 78 70 72 70 72 77 77 70 72 70 72 70 72 99 77 
99 99 99 78 99 99 99 99 99 99 99 77 70 72 70 72 70 72 70 72 70 72 78 78 70 72 70 72 70 72 70 72 70 72 77 99 99 72 99 78 78 78 78 78 78 78 77 99 77 72 70 72 70 72 77 99 99 99 99 78 99 99 99 77 70 72 70 78 78 72 70 72 70 72 70 99 78 78  
99 99 99 99 99 99 99 99 99 99 99 77 72 70 72 70 72 70 72 70 72 70 72 70 72 70 72 70 72 70 72 70 72 70 77 99 99 70 78 70 72 70 72 70 72 70 77 77 77 70 72 70 72 70 77 99 99 99 99 99 99 99 99 78 99 70 72 70 72 70 72 70 72 70 99  
99 99 99 99 99 99 99 99 99 99 99 78 70 72 70 72 70 77 70 72 70 72 70 72 70 72 70 72 70 72 70 72 70 72 78 99 99 72 70 72 70 72 70 72 70 72 78 78 78 72 70 72 70 72 77 99 77 78 99 99 99 99 99 99 99 72 70 72 70 72 70 72 99 99 77 78 
99 99 99 99 99 99 99 99 99 99 99 99 78 78 78 78 78 77 72 70 72 70 77 77 72 70 72 70 72 70 72 70 72 70 99 99 99 99 77 70 72 70 72 70 72 70 72 70 72 70 72 70 72 70 77 99 77 99 99 99 99 99 99 99 99 99 72 70 72 99 99 99 99 99 78  
99 99 99 99 99 99 99 99 99 99 99 99 99 99 99 99 99 77 70 72 70 72 77 77 70 72 70 72 70 72 70 72 70 72 77 99 78 99 77 72 70 72 70 72 70 72 70 72 70 72 70 72 70 72 77 99 78 99 99 99 99 99 99 99 99 78 99 99 99 99 99 78 78
99 99 99 99 99 99 99 99 99 99 99 99 78 78 99 78 99 77 72 70 72 70 77 77 72 70 72 70 72 70 72 70 72 70 77 99 99 99 78 70 72 70 72 70 72 70 77 99 77 70 72 70 72 70 78 99 99 99 99 99 99 99 99 99 99 99 77 78  
99 99 99 99 99 99 99 99 99 99 99 99 99 99 99 99 99 78 78 78 78 78 77 77 70 72 70 72 70 72 70 72 70 72 77 99 77 99 99 78 78 77 77 77 77 78 78 99 77 72 70 72 70 72 99 99 99 99 99 99 99 99 99 99 99 99 78
99 99 99 99 99 99 99 99 99 99 99 99 99 99 99 99 99 99 99 99 99 99 78 77 72 70 72 70 72 70 72 70 72 70 77 99 78 99 99 99 99 78 78 78 78 99 99 99 77 70 72 70 72 70 77 
99 99 99 99 99 99 99 99 99 99 99 99 99 99 99 99 99 78 99 99 99 78 99 77 77 78 78 77 77 77 77 78 78 78 78 99 99 99 99 99 99 99 99 99 99 99 99 99 78 72 70 72 70 72 77 
99 99 99 99 99 99 99 99 99 99 99 99 99 99 99 99 99 99 99 99 99 99 99 78 78 99 99 78 78 78 78 99 99 99 99 99 99 99 99 78 78 99 99 99 99 99 99 77 99 78 78 77 77 77 78
99 99 99 99 99 99 99 99 99 99 99 99 99 99 99 99 99 99 99 99 99 99 99 99 99 99 99 99 99 99 99 99 78 99 99 99 99 99 99 99 99 99 99 99 99 99 99 78 99 99 99 78 78 78 
99 99 99 99 99 99 99 99 99 99 99 99 99 99 99 99 99 99 99 99 99 99 99 78 78 

# Items Layer
99 99 99 99 99 99 99 99 99 99 99 99 99 99 99 99 99 99 99 99 99 99 99 99 99 99 99 99 99 99 99 99 99 99 99 99 99 99 99 99 99 99 99 99 99 99 99
99 99 99 99 99 99 99 99 99 99 99 99 99 99 99 99 99 99 99 99 99 99 99 99 99 99 99 99 99 99 99 99 99 99 99 99 99 99 99 99 99 99 99 99 99 99 99 99 99 99 99
99 99 99 99 99 99 99 99 99 99 99 99 99 99 99 99 99 99 99 99 99 99 99 99 99 99 99 99 99 99 99 99 99 99 99 99 99 99 99 99 99 99 99 99 99 43 99 99 
99 99 99 99 99 99 99 99 99 99 99 99 99 99 99 99 99 99 99 99 99 99 99 99 99 99 99 99 99 99 99 99 99 99 99 99 99 99 99 99 99 99 99 68 99 41 99 99 99 99 99 99 99 99 99 99 99 99 99 99 99
99 99 99 99 99 99 99 99 99 99 99 99 99 99 99 99 99 99 99 99 99 99 99 99 99 99 99 99 99 99 99 99 99 99 99 99 99 99 99 99 99 99 99 42 99 99 99 99 99 99 99 99 99 99 99 99 99 99 99
99 99 99 99 99 99 99 99 99 99 99 99 99 99 99 99 99 99 99 99 99 99 99 99 99 99 99 99 99 99 99 99 99 99 99 99 99 99 99 99 99 99 99 99 99 99 99 99 99 99 99 99 99 99 99 99 26 27 99 
99 99 99 99 99 99 99 99 99 99 99 99 99 99 99 99 99 99 99 99 99 99 99 99 99 99 99 99 99 99 99 99 99 99 99 99 99 99 99 99 99 99 99 99 70 70 99 99 99 99 99 40 99 99 99 99 99 47 99 
99 99 99 99 99 99 99 99 99 99 99 99 99 99 99 99 99 99 99 99 99 99 99 99 99 99 99 99 99 99 99 99 99 99 99 99 99 99 99 99 99 99 99 99 99 99 52 99 99 99 99 99 38 99 99 99 99 99 99 99 99 99
99 99 99 99 99 99 99 99 99 99 99 99 99 99 47 99 99 99 99 99 99 99 99 99 99 99 99 99 99 99 99 99 99 99 99 99 99 99 99 99 99 99 99 99 99 99 99 99 99 99 99 52 67 66 99 99 99 99 99 99 99 99
99 99 99 99 99 99 99 99 99 99 99 32 99 99 99 99 99 99 99 99 99 99 99 99 99 99 99 99 99 99 99 99 99 99 99 99 99 99 99 99 99 99 99 99 99 99 99 99 99 99 99 99 99 99 99 99 99 99 99 99 99 99 99 99 99 99 99 99 
99 99 99 33 99 99 52 69 99 99 99 99 99 99 99 99 99 99 99 99 47 99 99 99 99 99 99 99 99 99 99 99 99 99 99 99 34 99 99 99 99 99 99 99 99 99 99 99 99 99 99 99 99 99 99 99 99 99 99 99 99 99 99 99 99 99 99 99 99 99 99 99 99
99 99 99 99 99 99 99 99 99 99 99 99 99 99 99 99 99 99 99 99 99 99 99 38 99 99 99 99 99 99 99 99 68 69 53 99 99 32 99 99 99 99 99 99 99 99 99 99 99 99 99 99 99 99 43 99 99 99 99 99 99 99
99 99 99 99 99 99 99 99 99 99 99 99 99 42 99 99 99 99 99 99 99 99 99 99 99 99 99 99 99 99 99 99 99 99 99 99 99 99 99 99 99 99 99 99 99 99 99 99 99 99 99 99 99 99 99 99 99 99 99 99 99 99 99 99 99 99 99 99 99 99 99 99 99 99 99
99 99 99 99 99 99 99 99 99 99 99 99 99 99 52 99 99 99 99 99 99 68 99 99 99 99 99 99 99 99 99 43 99 99 99 99 66 99 99 99 99 99 47 99 99 99 99 99 99 99 99 99 99 99 34 99 99 99 99 99 99 99 99 99 99 99 99 99 99 99 99 99 99 99 
99 99 99 99 51 99 99 99 99 99 99 99 99 99 99 99 99 99 99 99 99 47 99 99 99 99 99 99 99 99 99 99 99 41 99 99 67 99 43 99 99 99 68 67 99 69 99 99 99 99 99 99 99 99 99 99 48 99 99 99 99 99 99 99 99 99 99 99 99 99 99 99 99 99  
99 99 99 99 46 99 99 99 99 99 99 99 99 99 99 99 99 99 99 99 99 99 42 99 99 99 99 99 99 49 99 99 99 99 99 99 99 99 99 99 99 99 99 99 99 99 34 32 99 99 99 99 99 99 26 99 99 99 99 99 99 99 99 99 99 99 99 99 99 99 99 99 99 99 99 
99 99 99 70 99 99 99 99 99 99 99 99 99 99 99 66 67 99 99 99 99 99 99 99 99 99 99 99 99 99 99 99 99 99 99 99 99 99 99 99 99 99 49 99 99 99 99 66 99 99 99 99 99 99 99 99 32 99 99 99 99 99 99 99 99 99 99 99 99 99 99 99 99 99 99   
99 99 99 99 99 99 99 34 99 99 99 49 99 99 99 99 99 99 99 99 99 99 99 99 99 99 99 99 99 99 99 99 99 99 99 99 99 99 99 99 99 99 99 50 99 45 99 99 99 99 99 99 99 99 99 99 99 99 99 99 99 99 99 99 99 99 99 99 99 99 99 99 99 99 99 99 99 
99 99 99 99 41 99 99 99 99 99 99 99 99 99 99 99 99 99 99 99 99 99 68 99 99 99 99 99 99 99 99 99 99 99 99 99 99 99 99 99 99 99 99 99 99 99 99 99 99 99 99 99 99 99 99 40 99 99 99 99 99 99 99 46 99 99 99 99 99 99 99 99 99 99 99  
99 99 99 99 99 99 99 99 33 99 99 99 99 99 99 99 99 99 99 99 49 99 70 66 99 99 99 99 99 99 99 99 99 99 99 99 45 99 99 99 99 99 99 66 67 70 99 99 99 99 99 99 99 99 41 99 99 99 99 47 99 99 46 99 99 99 99 99 99 99 99 99 99 99 99  
99 99 99 99 99 99 99 99 99 99 99 99 99 99 99 99 99 99 99 99 99 99 99 99 99 99 99 99 99 99 99 99 99 99 99 99 99 64 99 99 99 99 99 42 99 99 99 99 99 99 99 99 99 99 99 99 99 46 99 99 99 47 99 99 99 99 99 99 99 99 99 99 99 99 99 
99 99 99 99 99 99 99 99 99 99 99 99 69 99 99 99 99 99 99 99 99 99 99 99 99 99 99 99 99 99 99 99 99 99 99 99 99 47 34 99 99 99 99 99 99 99 38 99 99 99 99 99 99 99 99 99 99 99 99 99 45 99 45 99 47 99 99 99 99 99 99 99 99 99 99 99 99 99  
99 99 99 99 99 99 99 99 99 99 99 99 99 99 99 99 99 99 99 99 99 99 99 99 99 40 99 99 99 99 99 99 99 99 99 99 99 99 99 99 99 26 99 99 99 99 99 99 99 99 99 99 99 99 99 99 99 99 99 99 99 99 99 99 99 99 99 99 99 99 99 99 99 99 99  
99 99 99 99 99 99 99 99 99 99 99 99 99 99 99 50 99 99 99 99 99 99 99 99 99 99 99 99 99 99 43 50 99 99 99 99 99 99 99 99 99 99 99 99 99 99 99 99 99 99 99 99 99 99 99 99 99 99 99 99 99 99 99 45 99 99 99 99 99 99 99 99 99 99 99  
99 99 99 99 99 99 99 99 99 99 99 99 66 99 99 99 99 99 99 99 99 99 99 99 99 99 68 99 99 99 99 99 99 99 99 99 99 99 99 99 99 99 99 99 99 99 99 99 99 99 99 99 99 99 99 99 99 99 99 99 99 99 99 99 99 99 99 99 99 99 99 99 99 99 99 99 99 
99 99 99 99 99 99 99 99 99 99 99 99 99 99 99 99 99 99 99 52 99 99 99 99 99 99 68 99 99 99 67 99 99 99 99 99 99 99 99 99 99 99 99 99 99 99 99 99 99 99 99 99 64 99 99 99 99 99 99 99 99 99 99 99 99 99 99 99 99 99 99 99 99 99 99 99 99 99  
99 99 99 99 99 99 99 99 99 99 99 99 68 99 99 99 99 99 99 99 99 99 99 99 99 99 99 34 99 99 99 99 99 99 99 99 99 99 99 99 33 45 99 99 99 99 99 99 99 99 99 99 99 99 99 99 99 99 99 99 99 99 99 99 99 99 99 99 99 99 99 99 99 99   
99 99 99 99 99 99 99 99 99 99 99 99 68 99 99 99 99 99 99 99 99 99 99 99 99 99 69 99 99 99 68 99 99 99 99 99 99 99 99 99 99 99 99 99 34 99 99 99 99 99 99 99 99 99 99 99 99 99 99 99 99 99 99 99 99 99 99 99 99 99 99 99 99 99 99 99 
99 99 99 99 99 99 99 99 99 99 99 99 99 99 99 99 99 99 99 99 69 99 99 99 99 99 68 99 99 99 99 99 99 99 99 99 99 99 99 99 99 99 99 99 99 99 99 99 99 99 67 99 99 99 99 99 99 99 99 99 99 99 99 99 99 99 99 99 99 99 99 99 99 99 99  
99 99 99 99 99 99 99 99 99 99 99 99 99 99 99 99 99 99 50 99 99 99 99 99 99 99 99 99 99 99 66 99 99 99 99 99 99 99 99 99 99 99 52 68 99 99 99 99 99 99 99 99 70 99 99 99 99 99 99 99 99 99 99 99 99 99 99 99 99 99 99 99 99
99 99 99 99 99 99 99 99 99 99 99 99 99 99 99 99 99 99 99 99 99 99 99 99 99 99 99 99 99 99 68 99 99 99 99 99 99 99 99 99 99 99 99 99 99 99 99 99 99 99 99 99 70 99 99 99 99 99 99 99 99 99 99 99 99 99 99 99  
99 99 99 99 99 99 99 99 99 99 99 99 99 99 99 99 99 99 99 99 99 99 99 99 99 49 99 99 99 99 99 99 52 42 99 99 99 99 99 99 99 99 99 99 99 99 99 99 99 99 99 99 99 99 99 99 99 99 99 99 99 99 99 99 99 99 99
99 99 99 99 99 99 99 99 99 99 99 99 99 99 99 99 99 99 99 99 99 99 99 99 99 99 99 99 99 99 99 99 99 99 99 99 99 99 99 99 99 99 99 99 99 99 99 99 99 99 47 99 99 99 99 
99 99 99 99 99 99 99 99 99 99 99 99 99 99 99 99 99 99 99 99 99 99 99 99 99 99 99 99 99 99 99 99 99 99 99 99 99 99 99 99 99 99 99 99 99 99 99 99 99 99 99 99 99 99 99 
99 99 99 99 99 99 99 99 99 99 99 99 99 99 99 99 99 99 99 99 99 99 99 99 99 99 99 99 99 99 99 99 99 99 99 99 99 99 99 99 99 99 99 99 99 99 99 99 99 99 99 99 99 99 99
99 99 99 99 99 99 99 99 99 99 99 99 99 99 99 99 99 99 99 99 99 99 99 99 99 99 99 99 99 99 99 99 99 99 99 99 99 99 99 99 99 99 99 99 99 99 99 99 99 99 99 99 99 99 
99 99 99 99 99 99 99 99 99 99 99 99 99 99 99 99 99 99 99 99 99 99 99 99 99 

# Entity Layer
0  0  0  0  0  0  0  0  0  0  0  0  0  0  0  0  0  0  0  0  0  0  0  0  0  0  0  0  0  0  0  0  0  0  0  0  0  0  0  0  0  0  0  0  0  0  0 
0  0  0  0  0  0  0  0  0  0  0  0  0  0  0  0  0  0  0  0  0  0  0  0  0  0  0  0  0  0  0  0  0  0  0  0  0  0  0  0  0  0  70 72 70 72 70 0  0  0  0
0  0  0  0  0  0  0  0  0  0  0  0  0  0  0  0  0  0  0  0  0  0  0  0  0  0  0  0  0  0  0  0  0  0  0  0  0  0  0  0  0  0  72 70 72 70 72 0  
0  0  0  0  0  0  0  0  0  0  0  0  0  0  0  0  0  0  0  0  0  0  0  0  0  0  0  0  0  0  0  0  0  0  0  0  0  0  0  0  0  0  70 72 70 72 70 0  0  0  0  0  0  0  0  0  0  0  0  0  0
0  0  0  0  0  0  0  0  0  0  0  0  0  0  0  0  0  0  0  0  0  0  0  0  0  0  0  0  0  0  0  0  0  0  0  0  0  0  0  0  0  0  72 70 72 70 72 0  0  0  0  0  0  0  0  0  0  0  0 
0  0  0  0  0  0  0  0  0  0  0  0  0  0  0  0  0  0  0  0  0  0  0  0  0  0  0  0  0  0  0  0  0  0  0  0  0  0  0  0  0  0  70 72 70 72 70 72 70 72 70 72 70 72 70 72 70 72 0  
0  0  0  0  0  0  0  0  0  0  0  0  0  0  0  0  0  0  0  0  0  0  0  0  0  0  0  0  0  0  0  0  0  0  0  0  0  0  0  0  0  0  72 70 72 70 72 70 72 70 72 70 72 70 72 70 72 70 0  0
0  0  0  0  0  0  0  0  0  0  0  0  0  0  0  0  0  0  0  0  0  0  0  0  0  0  0  0  0  0  0  0  0  0  0  0  0  0  0  0  0  0  70 72 70 72 70 0  0  0  70 72 70 72 70 72 70 72 0  0  0  0 
0  0  0  0  0  0  0  0  0  0  0  70 72 70 72 0  0  0  0  0  0  0  0  0  0  0  0  0  0  0  0  0  0  0  0  0  0  0  0  0  0  0  0  0  72 70 0  0  0  0  72 70 72 70 72 70 72 70 0  0  0  0 
0  0  0  0  0  0  0  0  0  0  0  72 70 72 70 0  0  0  0  0  0  0  0  0  0  0  0  0  0  72 70 72 70 72 70 72 70 72 70 0  0  0  0  0  70 72 0  0  0  0  70 72 70 72 70 72 77 72 0  0  0  0  0  0  0  0  0  0  0
0  0  0  70 72 70 72 70 72 0  0  5  72 70 72 0  0  0  0  70 72 70 72 70 72 0  0  0  0  70 72 70 77 70 72 70 72 70 72 0  0  0  0  0  72 70 0  0  0  0  0  0  0  0  72 70 72 0  0  0  0  0  0  0  0  0  0  0  0  0  0  0  0 
0  0  0  72 70 72 70 72 70 72 70 72 70 72 70 72 70 72 70 72 70 72 70 72 70 72 70 72 70 72 70 72 70 72 70 72 70 72 70 0  0  0  0  0  70 72 0  0  0  0  0  0  0  0  70 72 70 0  0  0  0  0 
0  0  0  70 72 70 72 70 72 70 72 70 72 70 72 70 72 70 72 70 72 70 72 70 72 70 72 70 72 70 72 70 72 70 72 70 72 70 72 0  0  70 72 70 72 70 72 70 0  0  0  0  0  0  72 70 72 0  0  0  0  0  0  0  0  0  0  0  0  0  0  0  0  0  0
0  0  0  72 70 72 70 72 70 0  0  72 70 72 70 0  0  0  0  72 70 72 70 72 70 0  0  0  0  72 70 72 70 72 70 72 70 72 70 0  0  72 70 72 70 72 70 72 0  0  0  0  0  0  70 72 70 0  0  0  0  0  0  0  0  0  0  0  0  0  70 72 70 72 0 
0  0  0  70 72 1  4  70 72 0  0  0  0  0  0  0  0  0  0  70 72 70 72 70 72 0  0  0  0  70 72 70 72 70 72 70 72 70 72 0  0  70 72 70 72 70 72 70 0  0  0  0  0  0  72 70 72 0  0  0  0  0  0  0  0  70 72 70 72 70 72 70 72 70 0  
0  0  0  72 70 72 70 72 70 0  0  0  0  0  0  0  0  0  0  72 70 72 70 72 70 0  0  0  0  72 70 72 70 72 70 72 70 72 70 0  0  72 70 72 70 72 70 72 0  0  0  0  0  0  70 72 70 0  0  0  0  0  0  72 70 72 70 72 70 9  70 72 70 72 70 0 
0  0  0  70 72 70 72 70 72 0  0  0  72 70 72 70 72 0  0  70 77 70 72 70 72 0  0  0  0  0  0  0  0  0  0  0  0  70 0  0  0  70 72 70 72 70 72 70 0  0  0  0  0  0  72 70 72 0  0  0  0  0  0  70 72 70 0  0  72 70 72 70 72 70 72 0   
0  0  0  72 5  72 70 72 70 72 70 72 70 72 70 72 70 0  0  72 70 72 70 72 70 0  0  0  0  0  0  0  0  0  0  0  0  72 0  0  0  72 70 72 70 72 70 72 0  0  0  0  0  0  70 72 70 0  0  0  0  0  0  72 70 72 0  0  70 0  70 72 0  0  70 0  0  
0  0  0  70 72 70 72 70 72 70 72 70 72 70 72 70 72 70 72 70 72 70 72 70 72 0  0  0  0  0  0  0  0  0  0  0  0  70 0  0  0  70 72 70 72 70 72 70 0  0  0  0  0  0  72 70 72 0  0  0  0  0  0  70 72 70 72 70 72 0  72 70 0  0  72 70 0 
0  0  0  72 70 72 70 72 70 0  0  0  70 72 70 72 70 72 70 72 70 72 70 72 70 0  0  0  0  0  0  0  0  0  0  0  70 72 70 0  0  72 70 72 70 72 70 72 0  0  0  0  0  0  70 72 70 72 70 72 70 72 70 72 70 72 70 72 70 72 70 72 70 72 70 72 0 
0  0  0  0  0  0  0  0  0  0  0  0  72 70 72 70 72 0  0  70 72 70 72 70 5  0  0  0  0  0  0  0  0  0  0  0  72 70 72 70 72 70 72 70 72 70 72 70 0  0  0  0  0  0  72 70 72 70 72 70 72 70 72 70 72 70 72 70 72 70 72 70 72 70 72 70 0 
0  0  0  0  0  0  0  0  0  0  0  0  70 77 70 72 70 0  0  0  0  0  0  0  0  0  0  0  0  0  0  0  0  0  0  0  70 72 70 0  0  72 70 72 70 72 70 72 0  0  0  0  0  0  70 72 70 72 70 72 70 72 70 72 70 72 70 72 70 0  70 72 70 72 70 72 0  0   
0  0  0  0  0  0  0  0  0  0  0  0  72 70 72 70 72 0  0  0  0  0  0  0  72 70 72 70 72 70 72 70 72 70 0  0  0  70 0  0  0  70 72 70 72 70 72 70 0  0  0  0  0  0  0  0  0  0  0  0  0  0  0  70 72 70 72 70 72 70 72 70 72 70 72 0 
0  0  0  0  0  0  0  0  0  0  0  0  70 72 70 72 70 0  0  0  0  0  0  0  70 72 70 72 70 72 70 72 70 72 70 72 70 72 0  0  0  0  0  0  0  0  0  0  0  0  0  0  0  0  0  0  0  0  0  0  0  0  0  72 70 72 70 72 70 72 70 72 70 72 70 0  
0  0  0  0  0  0  0  0  0  0  0  0  72 70 72 70 72 0  72 70 72 70 0  0  72 70 72 77 72 70 72 70 72 70 0  0  0  70 0  0  0  0  0  0  0  0  0  0  0  0  0  0  0  0  0  0  0  0  0  0  0  0  0  70 72 70 72 0  0  70 72 70 72 70 72 0  0  
0  0  0  0  0  0  0  0  0  0  0  0  70 72 70 72 70 72 70 72 70 72 0  0  70 72 70 72 70 72 70 72 70 72 0  0  0  72 0  0  0  0  0  0  0  0  0  0  0  72 70 72 70 72 0  0  0  0  0  0  0  0  0  0  70 72 70 0  0  72 70 72 70 72 70 0  0  0   
0  0  0  0  0  0  0  0  0  0  0  0  72 70 72 70 72 70 72 70 72 70 72 70 72 70 72 70 72 70 72 70 72 70 0  0  0  70 0  70 72 70 72 70 72 70 0  0  0  70 72 70 72 70 0  0  0  0  0  0  0  0  0  0  0  70 72 70 72 70 72 70 72 70 0   
0  0  0  0  0  0  0  0  0  0  0  0  70 72 70 72 70 0  70 72 70 72 70 72 70 72 70 72 2  72 70 72 70 72 0  0  0  72 70 72 70 72 70 72 70 72 0  0  0  72 70 72 70 72 0  0  0  0  0  0  0  0  0  0  0  72 70 72 70 72 70 72 0  0  0  0  
0  0  0  0  0  0  0  0  0  0  0  0  0  0  0  0  0  0  72 70 72 70 0  0  72 70 72 70 72 70 72 70 72 70 0  0  0  0  0  70 72 70 72 70 72 70 72 70 72 70 72 70 72 70 0  0  0  0  0  0  0  0  0  0  0  0  72 70 72 0  0  0  0  0  0   
0  0  0  0  0  0  0  0  0  0  0  0  0  0  0  0  0  0  70 72 70 72 0  0  70 72 70 72 70 72 70 72 70 72 0  0  0  0  0  72 77 72 70 72 70 72 70 72 70 72 70 72 70 72 0  0  0  0  0  0  0  0  0  0  0  0  0  0  0  0  0  0  0 
0  0  0  0  0  0  0  0  0  0  0  0  0  0  0  0  0  0  72 70 72 70 0  0  72 70 72 70 72 77 72 70 72 70 0  0  0  0  0  70 72 70 72 70 72 70 0  0  0  70 72 70 72 70 0  0  0  0  0  0  0  0  0  0  0  0  0  0   
0  0  0  0  0  0  0  0  0  0  0  0  0  0  0  0  0  0  0  0  0  0  0  0  70 72 70 72 70 72 70 72 70 72 0  0  0  0  0  0  0  0  0  0  0  0  0  0  0  72 70 72 70 72 0  0  0  0  0  0  0  0  0  0  0  0  0 
0  0  0  0  0  0  0  0  0  0  0  0  0  0  0  0  0  0  0  0  0  0  0  0  72 70 72 70 72 70 72 70 72 70 0  0  0  0  0  0  0  0  0  0  0  0  0  0  0  70 72 70 72 70 0  
0  0  0  0  0  0  0  0  0  0  0  0  0  0  0  0  0  0  0  0  0  0  0  0  0  0  0  0  0  0  0  0  0  0  0  0  0  0  0  0  0  0  0  0  0  0  0  0  0  72 70 72 70 72 0  
0  0  0  0  0  0  0  0  0  0  0  0  0  0  0  0  0  0  0  0  0  0  0  0  0  0  0  0  0  0  0  0  0  0  0  0  0  0  0  0  0  0  0  0  0  0  0  0  0  0  0  0  0  0  0 
0  0  0  0  0  0  0  0  0  0  0  0  0  0  0  0  0  0  0  0  0  0  0  0  0  0  0  0  0  0  0  0  0  0  0  0  0  0  0  0  0  0  0  0  0  0  0  0  0  0  0  0  0  0  
0  0  0  0  0  0  0  0  0  0  0  0  0  0  0  0  0  0  0  0  0  0  0  0  0 