99 99 99 99 99 99 99 99 99 99 99 99 99 99 99 99 99 99 99 99 99 99 99 99 99 99 99 99 99 99 99 99 99 99 99 99 99 99 99 99 99 5  6  6  99 6  6 
99 99 99 99 99 99 99 99 99 99 99 99 99 99 99 99 99 99 99 99 99 99 99 99 99 99 99 99 99 99 99 99 99 99 99 99 6  99 99 99 99 5  21 14 21 14 21 5  99 99 6
99 99 99 99 99 99 99 99 99 99 99 99 99 99 99 99 99 99 99 99 99 99 99 99 99 99 99 99 99 99 99 99 99 99 99 99 99 99 99 99 6  5  14 21 14 21 14 5  
99 99 99 99 99 99 99 99 99 99 99 99 99 99 99 99 99 99 99 99 99 99 99 99 99 99 99 99 99 99 99 99 99 99 99 99 99 99 6  99 99 5  21 14 21 14 21 5  5  99 99 99 99 5  5  5  5  99 99 99 6
99 99 99 99 99 99 99 99 99 99 99 99 6  99 99 99 99 99 99 99 99 99 99 99 99 99 99 99 99 99 99 99 99 99 99 99 99 99 99 99 5  5  14 21 14 21 14 6  6  6  6  6  6  6  6  6  6  6  5 
99 99 99 99 99 99 99 99 99 99 99 99 99 99 99 99 99 99 99 99 99 6  5  99 99 99 99 99 99 99 99 99 99 6  6  99 99 99 99 99 6  5  21 14 21 14 21 14 21 14 21 14 21 14 21 14 21 14 5  
99 99 99 99 99 99 6  6  99 99 99 5  5  5  99 99 99 99 99 99 99 99 6  99 99 99 99 99 99 6  99 99 99 99 99 99 99 99 99 99 99 5  14 21 14 21 14 21 14 21 14 21 14 21 14 21 14 21 5  5
99 99 99 99 99 99 99 99 99 99 5  6  6  6  6  5  99 6  99 99 99 99 99 99 99 99 99 99 99 99 99 99 5  5  5  5  5  5  99 99 99 6  21 14 21 14 21 6  6  5  21 14 21 14 21 14 21 14 5  5  99 5 
99 99 99 6  5  99 99 5  6  5  5  21 14 21 14 5  99 99 99 99 5  5  99 99 99 99 6  99 5  6  6  6  6  6  6  6  6  6  6  99 99 99 6  6  14 21 5  99 99 5  14 21 14 21 14 21 14 21 5  6  99 6 
99 99 5  99 6  6  6  6  99 5  5  14 21 14 21 5  99 5  5  6  6  6  6  6  6  5  99 99 5  14 21 14 21 14 21 14 21 14 21 5  99 99 99 99 21 14 5  99 99 5  21 14 21 14 21 14 21 14 5  99 99 99 99 99 99 99 99 6  5
99 6  5  21 14 21 14 21 14 6  6  21 14 21 14 6  6  6  6  21 14 21 14 21 14 6  6  99 6  21 14 21 14 21 14 21 14 21 14 5  99 99 5  5  14 21 5  5  99 5  5  6  6  5  14 21 14 5  6  99 99 99 99 99 99 99 99 99 6  99 99 99 6 
99 99 5  14 21 14 21 14 21 14 21 14 21 14 21 14 21 14 21 14 21 14 21 14 21 14 21 14 21 14 21 14 21 14 21 14 21 14 21 5  99 6  6  6  21 14 6  6  5  5  6  99 99 5  21 14 21 5  99 99 99 5 
99 99 6  21 14 21 14 21 14 21 14 21 14 21 14 21 14 21 14 21 14 21 14 21 14 21 14 21 14 21 14 21 14 21 14 21 14 21 14 5  5  21 14 21 14 21 14 21 5  5  99 99 99 5  14 21 14 5  99 99 99 5  99 99 99 99 99 99 99 99 6  99 99 99 6
99 99 99 14 21 14 21 14 21 5  5  14 21 14 21 6  6  99 5  14 21 14 21 14 21 5  5  6  6  14 21 14 21 14 21 14 21 14 21 5  5  14 21 14 21 14 21 14 5  6  99 99 99 5  21 14 21 5  5  99 99 6  99 99 5  6  99 99 99 99 21 14 21 14 
99 6  99 21 14 21 14 21 14 5  5  5  5  5  5  99 99 99 5  21 14 21 14 21 14 5  6  99 99 21 14 21 14 21 14 21 14 21 14 5  5  21 14 21 14 21 14 21 5  99 99 5  99 6  14 21 14 5  5  99 99 99 99 99 6  21 14 21 14 21 14 21 14 21  
99 99 99 14 21 14 21 14 21 5  5  5  6  6  6  6  6  99 6  14 21 14 21 14 21 6  99 99 5  14 21 14 21 14 21 14 21 14 21 5  5  14 21 14 21 14 21 14 6  99 99 6  99 99 21 14 21 5  5  99 99 99 5  14 21 14 21 14 21 14 21 14 21 14 21 
99 99 5  21 14 21 14 21 14 6  6  6  14 21 14 21 14 99 99 21 14 21 14 21 14 99 99 99 6  6  6  6  6  6  99 6  6  21 6  6  5  21 14 21 14 21 14 21 99 99 99 99 99 5  14 21 14 5  5  99 99 99 5  21 14 21 5  5  14 21 14 21 14 21 14   
6  99 5  14 21 14 21 14 21 14 21 14 21 14 21 14 21 6  99 14 21 14 21 14 21 5  99 99 99 99 99 99 99 99 99 99 99 14 99 99 5  14 21 14 21 14 21 14 5  99 99 99 5  5  21 14 21 5  5  99 99 5  5  14 21 14 6  6  21 14 21 14 5  5  21 99 6  
99 99 6  21 14 21 14 21 14 21 14 21 14 21 14 21 14 21 14 21 14 21 14 21 14 5  99 99 5  6  99 99 6  6  99 99 99 21 99 99 5  21 14 21 14 21 14 21 5  5  99 99 5  5  14 21 14 6  6  6  6  6  6  21 14 21 14 21 14 21 14 21 6  6  14 21 
99 99 99 14 21 14 21 14 21 6  6  5  21 14 21 14 21 14 21 14 21 14 21 14 21 5  99 99 6  99 99 99 99 99 99 99 21 14 21 99 6  14 21 14 21 14 21 14 5  5  99 99 6  5  21 14 21 14 21 14 21 14 21 14 21 14 21 14 21 14 21 14 21 14 21 14 
99 99 99 6  6  99 6  6  6  99 99 5  14 21 14 21 14 5  5  21 14 21 14 21 14 5  99 5  99 99 99 99 5  99 99 99 14 21 14 21 14 21 14 21 14 21 14 21 5  6  99 99 99 5  14 21 14 21 14 21 14 21 14 21 14 21 14 21 14 21 14 21 14 21 14 21
99 99 99 99 99 99 99 99 99 99 99 5  21 14 21 14 21 5  5  5  5  5  5  5  6  6  6  6  99 99 6  6  6  99 99 99 21 14 21 99 99 14 21 14 21 14 21 14 5  99 99 99 99 6  21 14 21 14 21 14 21 14 21 14 21 14 21 14 21 14 21 14 21 14 21 14 99 6   
99 99 99 99 6  99 99 6  5  99 99 5  14 21 14 21 14 5  5  5  5  5  5  5  14 21 14 21 14 21 14 21 14 21 99 99 99 21 99 99 6  21 14 21 14 21 14 21 5  99 99 99 99 99 6  6  6  5  5  5  5  6  5  21 14 21 14 21 14 21 14 21 14 21 14 24
99 99 99 99 99 99 99 99 6  99 99 5  21 14 21 14 21 5  6  6  6  6  5  5  21 14 21 14 21 14 21 14 21 14 21 14 21 14 99 99 99 5  5  6  6  5  5  6  5  5  5  5  99 99 99 99 99 6  6  6  6  99 5  14 21 14 21 14 21 14 21 14 21 14 21  
99 99 99 99 99 99 99 99 99 99 6  5  14 21 14 21 14 6  14 21 14 21 5  5  14 21 14 21 14 21 14 21 14 21 5  99 99 21 99 99 99 5  5  99 99 5  5  99 5  6  6  6  6  6  99 99 99 99 99 99 99 99 6  21 14 21 14 5  5  21 14 21 14 21 14 99 5  
99 99 99 6  99 99 99 99 99 99 99 5  21 14 21 14 21 14 21 14 21 14 6  6  21 14 21 14 21 14 21 14 21 14 5  99 99 14 99 6  6  6  6  6  6  6  5  99 5  14 21 14 21 14 5  99 99 99 99 6  99 99 99 5  21 14 21 6  6  14 21 14 21 14 21 99 6  6   
99 99 99 99 99 99 99 99 99 99 99 5  14 21 14 21 14 21 14 21 14 21 14 21 14 21 14 21 14 21 14 21 14 21 5  99 99 21 6  21 14 21 14 21 14 21 5  5  5  21 14 21 14 21 5  99 99 99 99 99 99 99 99 6  99 21 14 21 14 21 14 21 14 21   
99 99 99 99 99 99 99 99 99 99 99 6  21 14 21 14 21 5  21 14 21 14 21 14 21 14 21 14 21 14 21 14 21 14 6  99 99 14 21 14 21 14 21 14 21 14 6  6  6  14 21 14 21 14 5  99 5  6  99 99 99 99 99 99 99 14 21 14 21 14 21 14 99 99 5  6  
99 99 99 99 99 99 99 99 99 99 99 99 6  6  6  6  6  5  14 21 14 21 5  5  14 21 14 21 14 21 14 21 14 21 99 99 99 99 5  21 14 21 14 21 14 21 14 21 14 21 14 21 14 21 5  99 5  99 99 99 99 99 99 99 99 99 14 21 14 99 99 99 99 99 6   
99 99 99 99 99 99 99 99 99 99 99 99 99 99 99 99 99 5  21 14 21 14 5  5  21 14 21 14 21 14 21 14 21 14 5  99 6  99 5  14 21 14 21 14 21 14 21 14 21 14 21 14 21 14 5  99 6  99 99 99 99 99 99 99 99 6  99 99 99 99 99 6  6 
99 99 99 99 99 99 99 99 99 99 99 99 6  6  99 6  99 5  14 21 14 21 5  5  14 21 14 21 14 21 14 21 14 21 5  99 99 99 6  21 14 21 14 21 14 21 5  99 5  21 14 21 14 21 6  99 99 99 99 99 99 99 99 99 99 99 5  6   
99 99 99 99 99 99 99 99 99 99 99 99 99 99 99 99 99 6  6  6  6  6  5  5  21 14 21 14 21 14 21 14 21 14 5  99 5  99 99 6  6  5  5  5  5  6  6  99 5  14 21 14 21 14 99 99 99 99 99 99 99 99 99 99 99 99 6 
99 99 99 99 99 99 99 99 99 99 99 99 99 99 99 99 99 99 99 99 99 99 6  5  14 21 14 21 14 21 14 21 14 21 5  99 6  99 99 99 99 6  6  6  6  99 99 99 5  21 14 21 14 21 5  
99 99 99 99 99 99 99 99 99 99 99 99 99 99 99 99 99 6  99 99 99 6  99 5  5  6  6  5  5  5  5  6  6  6  6  99 99 99 99 99 99 99 99 99 99 99 99 99 6  14 21 14 21 14 5  
99 99 99 99 99 99 99 99 99 99 99 99 99 99 99 99 99 99 99 99 99 99 99 6  6  99 99 6  6  6  6  99 99 99 99 99 99 99 99 6  6  99 99 99 99 99 99 5  99 6  6  5  5  5  6 
99 99 99 99 99 99 99 99 99 99 99 99 99 99 99 99 99 99 99 99 99 99 99 99 99 99 99 99 99 99 99 99 6  99 99 99 99 99 99 99 99 99 99 99 99 99 99 6  99 99 99 6  6  6  
99 99 99 99 99 99 99 99 99 99 99 99 99 99 99 99 99 99 99 99 99 99 99 6  6  
99 99 99 

# Items Layer
99 99 99 99 99 99 99 99 99 99 99 99 99 99 99 99 99 99 99 99 99 99 99 99 99 99 99 99 99 99 99 99 99 99 99 99 99 99 99 99 99 99 99 99 99 99 99
99 99 99 99 99 99 99 99 99 99 99 99 99 99 99 99 99 99 99 99 99 99 99 99 99 99 99 99 99 99 99 99 99 99 99 99 99 99 99 99 99 99 75 74 75 74 75 99 99 99 99
99 99 99 99 99 99 99 99 99 99 99 99 99 99 99 99 99 99 99 99 99 99 99 99 99 99 99 99 99 99 99 99 99 99 99 99 99 99 99 99 99 99 74 75 74 43 74 99 
99 99 99 99 99 99 99 99 99 99 99 99 99 99 99 99 99 99 99 99 99 99 99 99 99 99 99 99 99 99 99 99 99 99 99 99 99 99 99 99 99 99 75 68 75 41 75 99 99 99 99 99 99 99 99 99 99 99 99 99 99
99 99 99 99 99 99 99 99 99 99 99 99 99 99 99 99 99 99 99 99 99 99 99 99 99 99 99 99 99 99 99 99 99 99 99 99 99 99 99 99 99 99 74 42 74 75 74 99 99 99 99 99 99 99 99 99 99 99 99
99 99 99 99 99 99 99 99 99 99 99 99 99 99 99 99 99 99 99 99 99 99 99 99 99 99 99 99 99 99 99 99 99 99 99 99 99 99 99 99 99 99 75 74 75 74 75 74 75 74 75 74 75 74 75 74 75 74 99 
99 99 99 99 99 99 99 99 99 99 99 99 99 99 99 99 99 99 99 99 99 99 99 99 99 99 99 99 99 99 99 99 99 99 99 99 99 99 99 99 99 99 74 75 70 70 74 75 74 75 74 75 74 75 74 75 74 75 99 
99 99 99 99 99 99 99 99 99 99 99 99 99 99 99 99 99 99 99 99 99 99 99 99 99 99 99 99 99 99 99 99 99 99 99 99 99 99 99 99 99 99 75 74 75 74 52 99 99 99 75 74 75 74 75 74 75 74 99 99 99 99
99 99 99 99 99 99 99 99 99 99 99 75 74 75 28 99 99 99 99 99 99 99 99 99 99 99 99 99 99 99 99 99 99 99 99 99 99 99 99 99 99 99 99 99 74 75 99 99 99 99 74 75 74 75 74 75 74 75 99 99 99 99
99 99 99 99 99 99 99 99 99 99 99 32 75 74 75 99 99 99 99 99 99 99 99 99 99 99 99 99 99 74 75 74 75 74 75 74 75 74 75 99 99 99 99 99 75 74 99 99 99 99 75 74 75 74 75 74 75 74 99 99 99 99 99 99 99 99 99 99 
99 99 99 33 74 75 52 69 99 99 99 75 74 75 74 99 99 99 99 75 29 75 74 75 74 99 99 99 99 75 74 75 74 75 74 75 34 75 74 99 99 99 99 99 74 75 99 99 99 99 99 99 99 99 74 75 74 99 99 99 99 99 99 99 99 99 99 99 99 99 99 99 99
99 99 99 74 75 74 75 74 75 74 75 74 75 74 75 74 75 74 75 74 75 74 75 38 75 74 75 74 75 74 75 74 68 69 53 74 75 32 75 99 99 99 99 99 75 74 99 99 99 99 99 99 99 99 75 74 75 99 99 99 99 99
99 99 99 75 74 75 74 75 74 75 74 75 74 42 74 75 74 75 74 75 74 75 74 75 74 75 74 75 74 75 74 75 74 75 74 75 74 75 74 99 99 75 74 75 74 75 74 75 99 99 99 99 99 99 74 75 74 99 99 99 99 99 99 99 99 99 99 99 99 99 99 99 99 99 99
99 99 99 74 75 74 75 74 75 99 99 74 75 74 52 99 99 99 99 74 75 68 75 74 75 99 99 99 99 74 75 43 75 74 75 74 75 74 75 99 99 74 75 74 75 74 75 74 99 99 99 99 99 99 75 74 75 99 99 99 99 99 99 99 99 99 99 99 99 99 75 74 75 74 
99 99 99 75 51 75 74 75 74 99 99 99 99 99 99 99 99 99 99 75 74 47 74 75 74 99 99 99 99 75 74 75 74 41 74 75 67 75 43 99 99 75 74 75 74 75 74 75 99 99 99 99 99 99 74 75 74 99 99 99 99 99 99 99 99 75 74 75 74 75 74 75 74 75  
99 99 99 74 46 74 75 74 75 99 99 99 99 99 99 99 99 99 99 74 75 74 42 74 75 99 99 99 99 49 75 74 75 74 75 74 75 74 75 99 99 74 75 74 75 74 75 74 99 99 99 99 99 99 75 74 75 99 99 99 99 99 99 74 75 74 75 74 75 74 75 74 75 74 75 
99 99 99 70 74 75 74 75 74 99 99 99 74 75 74 66 67 99 99 75 74 75 74 75 74 99 99 99 99 99 99 99 99 99 99 99 99 75 99 99 99 75 74 75 74 75 74 75 99 99 99 99 99 99 74 75 74 99 99 99 99 99 99 75 74 75 99 99 74 75 74 75 74 75 74   
99 99 99 74 75 74 75 34 75 74 75 49 75 74 75 74 75 99 99 74 75 74 75 74 75 99 99 99 99 99 99 99 99 99 99 99 99 74 99 99 99 74 75 74 75 74 75 74 99 99 99 99 99 99 75 74 75 99 99 99 99 99 99 74 75 74 99 99 75 74 75 74 99 99 75 99 99 
99 99 99 75 41 75 74 75 74 75 74 75 74 75 74 75 74 75 74 75 74 75 68 74 99 99 99 99 99 99 99 99 99 99 99 99 75 99 99 99 75 74 75 74 75 74 75 99 99 99 99 99 99 74 75 74 99 99 99 99 99 99 75 74 75 74 75 74 75 74 75 99 99 74  
99 99 99 74 75 74 75 74 33 99 99 99 75 74 75 74 75 74 75 74 49 74 70 66 75 99 99 99 99 99 99 99 99 99 99 99 45 74 75 99 99 74 75 74 75 74 75 74 99 99 99 99 99 99 75 74 75 74 75 74 75 74 75 74 75 74 75 74 75 74 75 74 75 74 75  
99 99 99 99 99 99 99 99 99 99 99 99 74 75 74 75 74 99 99 75 74 75 74 75 74 99 99 99 99 99 99 99 99 99 99 99 74 64 74 75 74 75 74 75 74 75 74 75 99 99 99 99 99 99 74 75 74 75 74 75 74 75 74 75 74 75 74 75 74 75 74 75 74 75 74 
99 99 99 99 99 99 99 99 99 99 99 99 69 74 75 74 75 99 99 99 99 99 99 99 99 99 99 99 99 99 99 99 99 99 99 99 75 47 34 99 99 74 75 74 75 74 75 74 99 99 99 99 99 99 75 74 75 74 75 74 75 74 75 74 75 74 75 74 75 74 75 74 75 74 75 99 99 99  
99 99 99 99 99 99 99 99 99 99 99 99 74 75 74 75 74 99 99 99 99 99 99 99 74 40 74 75 74 75 74 75 74 75 99 99 99 75 99 99 99 75 74 75 74 75 74 75 99 99 99 99 99 99 99 99 99 99 99 99 99 99 99 75 74 75 74 75 74 75 74 75 74 75 74  
99 99 99 99 99 99 99 99 99 99 99 99 75 74 75 50 75 99 99 99 99 99 99 99 75 74 75 74 75 74 43 50 75 74 75 74 75 74 99 99 99 99 99 99 99 99 99 99 99 99 99 99 99 99 99 99 99 99 99 99 99 99 99 74 75 74 75 74 75 74 75 74 75 74 75  
99 99 99 99 99 99 99 99 99 99 99 99 66 75 74 75 74 99 74 75 74 75 99 99 74 75 68 75 74 75 74 75 74 75 99 99 99 75 99 99 99 99 99 99 99 99 99 99 99 99 99 99 99 99 99 99 99 99 99 99 99 99 99 75 74 75 74 99 99 75 74 75 74 75 74 99 99 
99 99 99 99 99 99 99 99 99 99 99 99 99 74 75 74 75 74 75 52 75 74 99 99 75 74 68 74 75 74 67 74 75 74 99 99 99 74 99 99 99 99 99 99 99 99 99 99 99 74 75 74 64 74 99 99 99 99 99 99 99 99 99 99 75 74 75 99 99 74 75 74 75 74 75 99 99 99  
99 99 99 99 99 99 99 99 99 99 99 99 68 75 74 75 74 75 74 75 74 75 74 75 74 75 74 34 74 75 74 75 74 75 99 99 99 75 99 75 33 45 74 75 74 75 99 99 99 75 74 75 74 75 99 99 99 99 99 99 99 99 99 99 99 75 74 75 74 75 74 75 74 75   
99 99 99 99 99 99 99 99 99 99 99 99 68 74 75 74 75 99 75 74 75 74 75 74 75 74 69 74 75 74 68 74 75 74 99 99 99 74 75 74 75 74 75 74 34 74 99 99 99 74 75 74 75 74 99 99 99 99 99 99 99 99 99 99 99 74 75 74 75 74 75 74 99 99 99 99 
99 99 99 99 99 99 99 99 99 99 99 99 99 99 99 99 99 99 74 75 69 75 99 99 74 75 68 75 74 75 74 75 74 75 99 99 99 99 99 75 74 75 74 75 74 75 74 75 74 75 67 75 74 75 99 99 99 99 99 99 99 99 99 99 99 99 74 75 74 99 99 99 99 99 99  
99 99 99 99 99 99 99 99 99 99 99 99 99 99 99 99 99 99 50 74 75 74 99 99 75 74 75 74 75 74 66 74 75 74 99 99 99 99 99 74 75 74 52 68 75 74 75 74 75 74 75 74 70 74 99 99 99 99 99 99 99 99 99 99 99 99 99 99 99 99 99 99 99
99 99 99 99 99 99 99 99 99 99 99 99 99 99 99 99 99 99 74 75 74 75 99 99 74 75 74 75 74 75 68 75 74 75 99 99 99 99 99 75 74 75 74 75 74 75 99 99 99 75 74 75 70 75 99 99 99 99 99 99 99 99 99 99 99 99 99 99  
99 99 99 99 99 99 99 99 99 99 99 99 99 99 99 99 99 99 99 99 99 99 99 99 75 49 75 74 75 74 75 74 52 42 99 99 99 99 99 99 99 99 99 99 99 99 99 99 99 74 75 74 75 74 99 99 99 99 99 99 99 99 99 99 99 99 99
99 99 99 99 99 99 99 99 99 99 99 99 99 99 99 99 99 99 99 99 99 99 99 99 74 75 74 75 74 75 74 75 74 75 99 99 99 99 99 99 99 99 99 99 99 99 99 99 99 75 28 75 74 75 99 
99 99 99 99 99 99 99 99 99 99 99 99 99 99 99 99 99 99 99 99 99 99 99 99 99 99 99 99 99 99 99 99 99 99 99 99 99 99 99 99 99 99 99 99 99 99 99 99 99 74 75 74 75 74 99 
99 99 99 99 99 99 99 99 99 99 99 99 99 99 99 99 99 99 99 99 99 99 99 99 99 99 99 99 99 99 99 99 99 99 99 99 99 99 99 99 99 99 99 99 99 99 99 99 99 99 99 99 99 99 99
99 99 99 99 99 99 99 99 99 99 99 99 99 99 99 99 99 99 99 99 99 99 99 99 99 99 99 99 99 99 99 99 99 99 99 99 99 99 99 99 99 99 99 99 99 99 99 99 99 99 99 99 99 99 
99 99 99 99 99 99 99 99 99 99 99 99 99 99 99 99 99 99 99 99 99 99 99 99 99 
99 99 99 

# Entity Layer
0  0  0  0  0  0  0  0  0  0  0  0  0  0  0  0  0  0  0  0  0  0  0  0  0  0  0  0  0  0  0  0  0  0  0  0  0  0  0  0  0 
0  0  0  0  0  0  0  0  0  0  0  0  0  0  0  0  0  0  0  0  0  0  0  0  0  0  0  0  0  0  0  0  0  0  0  0  0  0  0  0  0 
0  0  0  0  0  0  0  0  0  0  0  0  0  0  0  0  0  0  0  0  0  0  0  0  0  0  0  0  0  0  0  0  0  0  0  0  0  0  0  0  0 
0  0  0  0  0  0  0  0  0  0  0  0  0  0  0  0  0  0  0  0  0  0  0  0  0  0  0  0  0  0  0  0  0  0  0  0  0  0  0  0  0 
0  0  0  0  0  0  0  0  0  0  0  0  0  0  0  0  0  0  0  0  0  0  0  0  0  0  0  0  0  0  0  0  0  0  0  0  0  0  0  0  0 
0  0  0  0  0  0  0  0  0  0  0  0  0  0  0  0  0  0  0  0  0  0  0  0  0  0  0  0  0  0  0  0  0  0  0  0  0  0  0  0  0 
0  0  0  0  0  0  0  0  0  0  0  0  0  0  0  0  0  0  0  0  0  0  0  0  0  0  0  0  0  0  0  0  0  0  0  0  0  0  0  0  0 
0  0  0  0  0  0  0  0  0  0  0  0  0  0  0  0  0  0  0  0  0  0  0  0  0  0  0  0  0  0  0  0  0  0  0  0  0  0  0  0  0 
0  0  0  0  0  0  0  0  0  0  0  0  0  0  0  0  0  0  0  0  0  0  0  0  0  0  0  0  0  0  0  0  0  0  0  0  0  0  0  0  0 
0  0  0  0  0  0  0  0  0  0  0  0  0  0  0  3  0  0  0  0  0  0  0  0  0  0  0  0  0  0  0  0  0  0  0  0  0  0  0  0  0 
0  0  0  0  0  0  0  0  0  0  0  0  0  0  0  0  0  0  0  0  0  0  0  0  0  0  0  0  0  0  0  0  0  0  0  0  0  0  0  0  0 
0  0  0  0  0  0  0  4  0  0  0  0  0  0  0  3  0  0  0  0  0  0  0  0  0  0  0  0  0  0  0  0  0  0  0  0  0  0  0  0  0 
0  0  0  0  0  0  0  0  0  0  0  0  0  0  0  0  0  0  0  0  0  0  0  0  0  0  0  0  0  0  0  0  0  0  0  0  0  0  0  0  0 
0  0  0  0  0  0  0  0  0  0  0  0  0  0  0  0  0  0  0  0  0  0  0  0  0  0  0  0  0  0  0  0  0  0  0  0  0  0  0  0  0 
0  0  0  0  0  0  1  0  0  0  0  0  0  0  0  0  0  0  0  0  0  0  0  0  0  0  0  0  0  0  0  0  0  0  0  0  0  0  0  0  0 
0  0  0  0  0  0  0  0  0  0  0  0  0  0  0  0  0  0  0  0  0  0  0  0  0  0  0  0  0  0  0  0  0  0  0  0  0  0  0  0  0 
0  0  0  0  0  0  0  0  0  0  0  0  0  0  0  0  0  0  0  0  0  0  0  0  0  0  0  0  0  0  0  0  0  0  0  0  0  0  0  0  0 
0  0  0  0  0  0  0  0  0  0  0  0  0  0  0  0  0  0  0  0  0  0  0  0  0  0  0  0  0  0  0  0  0  0  0  0  0  0  0  0  0 
0  0  0  0  0  0  0  0  0  0  0  0  0  0  0  0  0  0  0  0  0  0  0  0  0  0  0  0  0  0  0  0  0  0  0  0  0  0  0  0  0 
0  0  0  0  0  0  0  0  0  0  0  0  0  0  0  0  0  0  0  0  0  0  0  0  0  0  0  0  0  0  0  0  0  0  0  0  0  0  0  0  0 
0  0  0  0  0  0  0  0  0  0  0  0  0  0  0  0  0  0  0  0  0  0  0  0  0  0  0  0  0  0  0  0  0  0  0  0  0  0  0  0  0 
0  0  0  0  0  0  0  0  0  0  0  0  0  0  0  0  0  0  0  0  0  0  0  0  0  0  0  0  0  0  0  0  0  0  0  0  0  0  0  0  0 
0  0  0  0  0  0  0  0  0  0  0  0  0  0  0  0  0  0  0  0  0  0  0  0  0  0  0  0  0  0  0  0  0  0  0  0  0  0  0  0  0 