99 99 99 99 99 99 99 99 99 99 99 99 99 99 99 99 99 99 99 99 99 99 99 99 99 99 99 99 99 99 99 99 99 99 99 99 99 99 99 99 99 5  6  6  99 6  6 
99 99 99 99 99 99 99 99 99 99 99 99 99 99 99 99 99 99 99 99 99 99 99 99 99 99 99 99 99 99 99 99 99 99 99 99 6  99 99 99 99 5  21 14 21 14 21 5  99 99 6
99 99 99 99 99 99 99 99 99 99 99 99 99 99 99 99 99 99 99 99 99 99 99 99 99 99 99 99 99 99 99 99 99 99 99 99 99 99 99 99 6  5  14 21 14 21 14 5  
99 99 99 99 99 99 99 99 99 99 99 99 99 99 99 99 99 99 99 99 99 99 99 99 99 99 99 99 99 99 99 99 99 99 99 99 99 99 6  99 99 5  21 14 21 14 21 5  5  99 99 99 99 5  5  5  5  99 99 99 6
99 99 99 99 99 99 99 99 99 99 99 99 6  99 99 99 99 99 99 99 99 99 99 99 99 99 99 99 99 99 99 99 99 99 99 99 99 99 99 99 5  5  14 21 14 21 14 6  6  6  6  6  6  6  6  6  6  6  5 
99 99 99 99 99 99 99 99 99 99 99 99 99 99 99 99 99 99 99 99 99 6  5  99 99 99 99 99 99 99 99 99 99 6  6  99 99 99 99 99 6  5  21 14 21 14 21 14 21 14 21 14 21 14 21 14 21 14 5  
99 99 99 99 99 99 6  6  99 99 99 5  5  5  99 99 99 99 99 99 99 99 6  99 99 99 99 99 99 6  99 99 99 99 99 99 99 99 99 99 99 5  14 21 14 21 14 21 14 21 14 21 14 21 14 21 14 21 5  5
99 99 99 99 99 99 99 99 99 99 5  6  6  6  6  5  99 6  99 99 99 99 99 99 99 99 99 99 99 99 99 99 5  5  5  5  5  5  99 99 99 6  21 14 21 14 21 6  6  5  21 14 21 14 21 14 21 14 5  5  99 5 
99 99 99 6  5  99 99 5  6  5  5  21 14 21 14 5  99 99 99 99 5  5  99 99 99 99 6  99 5  6  6  6  6  6  6  6  6  6  6  99 99 99 6  6  14 21 5  99 99 5  14 21 14 21 14 21 14 21 5  6  99 6 
99 99 5  99 6  6  6  6  99 5  5  14 21 14 21 5  99 5  5  6  6  6  6  6  6  5  99 99 5  14 21 14 21 14 21 14 21 14 21 5  99 99 99 99 21 14 5  99 99 5  21 14 21 14 21 14 21 14 5  99 99 99 99 99 99 99 99 6  5
99 6  5  21 14 21 14 21 14 6  6  21 14 21 14 6  6  6  6  21 14 21 14 21 14 6  6  99 6  21 14 21 14 21 14 21 14 21 14 5  99 99 5  5  14 21 5  5  99 5  5  6  6  5  14 21 14 5  6  99 99 99 99 99 99 99 99 99 6  99 99 99 6 
99 99 5  14 21 14 21 14 21 14 21 14 21 14 21 14 21 14 21 14 21 14 21 14 21 14 21 14 21 14 21 14 21 14 21 14 21 14 21 5  99 6  6  6  21 14 6  6  5  5  6  99 99 5  21 14 21 5  99 99 99 5 
99 99 6  21 14 21 14 21 14 21 14 21 14 21 14 21 14 21 14 21 14 21 14 21 14 21 14 21 14 21 14 21 14 21 14 21 14 21 14 5  5  21 14 21 14 21 14 21 5  5  99 99 99 5  14 21 14 5  99 99 99 5  99 99 99 99 99 99 99 99 6  99 99 99 6
99 99 99 14 21 14 21 14 21 5  5  14 21 14 21 6  6  99 5  14 21 14 21 14 21 5  5  6  6  14 21 14 21 14 21 14 21 14 21 5  5  14 21 14 21 14 21 14 5  6  99 99 99 5  21 14 21 5  5  99 99 6  99 99 5  6  99 99 99 99 21 14 21 14 
99 6  99 21 14 21 14 21 14 5  5  5  5  5  5  99 99 99 5  21 14 21 14 21 14 5  6  99 99 21 14 21 14 21 14 21 14 21 14 5  5  21 14 21 14 21 14 21 5  99 99 5  99 6  14 21 14 5  5  99 99 99 99 99 6  21 14 21 14 21 14 21 14 21  
99 99 99 14 21 14 21 14 21 5  5  5  6  6  6  6  6  99 6  14 21 14 21 14 21 6  99 99 5  14 21 14 21 14 21 14 21 14 21 5  5  14 21 14 21 14 21 14 6  99 99 6  99 99 21 14 21 5  5  99 99 99 5  14 21 14 21 14 21 14 21 14 21 14 21 
99 99 5  21 14 21 14 21 14 6  6  6  14 21 14 21 14 99 99 21 14 21 14 21 14 99 99 99 6  6  6  6  6  6  99 6  6  21 6  6  5  21 14 21 14 21 14 21 99 99 99 99 99 5  14 21 14 5  5  99 99 99 5  21 14 21 5  5  14 21 14 21 14 21 14   
6  99 5  14 21 14 21 14 21 14 21 14 21 14 21 14 21 6  99 14 21 14 21 14 21 5  99 99 99 99 99 99 99 99 99 99 99 14 99 99 5  14 21 14 21 14 21 14 5  99 99 99 5  5  21 14 21 5  5  99 99 5  5  14 21 14 6  6  21 14 21 14 5  5  21 99 6  
99 99 6  21 14 21 14 21 14 21 14 21 14 21 14 21 14 21 14 21 14 21 14 21 14 5  99 99 5  6  99 99 6  6  99 99 99 21 99 99 5  21 14 21 14 21 14 21 5  5  99 99 5  5  14 21 14 6  6  6  6  6  6  21 14 21 14 21 14 21 14 21 6  6  14  
99 99 99 14 21 14 21 14 21 6  6  5  21 14 21 14 21 14 21 14 21 14 21 14 21 5  99 99 6  99 99 99 99 99 99 99 21 14 21 99 6  14 21 14 21 14 21 14 5  5  99 99 6  5  21 14 21 14 21 14 21 14 21 14 21 14 21 14 21 14 21 14 21 14 21  
99 99 99 6  6  99 6  6  6  99 99 5  14 21 14 21 14 5  5  21 14 21 14 21 14 5  99 5  99 99 99 99 5  99 99 99 14 21 14 21 14 21 14 21 14 21 14 21 5  6  99 99 99 5  14 21 14 21 14 21 14 21 14 21 14 21 14 21 14 21 14 21 14 21 14 
99 99 99 99 99 99 99 99 99 99 99 5  21 14 21 14 21 5  5  5  5  5  5  5  6  6  6  6  99 99 6  6  6  99 99 99 21 14 21 99 99 14 21 14 21 14 21 14 5  99 99 99 99 6  21 14 21 14 21 14 21 14 21 14 21 14 21 14 21 14 21 14 21 14 21 99 99 6   
99 99 99 99 6  99 99 6  5  99 99 5  14 21 14 21 14 5  5  5  5  5  5  5  14 21 14 21 14 21 14 21 14 21 99 99 99 21 99 99 6  21 14 21 14 21 14 21 5  99 99 99 99 99 6  6  6  5  5  5  5  6  5  21 14 21 14 21 14 21 14 21 14 21 14  
99 99 99 99 99 99 99 99 6  99 99 5  21 14 21 14 21 5  6  6  6  6  5  5  21 14 21 14 21 14 21 14 21 14 21 14 21 14 99 99 99 5  5  6  6  5  5  6  5  5  5  5  99 99 99 99 99 6  6  6  6  99 5  14 21 14 21 14 21 14 21 14 21 14 21  
99 99 99 99 99 99 99 99 99 99 6  5  14 21 14 21 14 6  14 21 14 21 5  5  14 21 14 21 14 21 14 21 14 21 5  99 99 21 99 99 99 5  5  99 99 5  5  99 5  6  6  6  6  6  99 99 99 99 99 99 99 99 6  21 14 21 14 5  5  21 14 21 14 21 14 99 5  
99 99 99 6  99 99 99 99 99 99 99 5  21 14 21 14 21 14 21 14 21 14 6  6  21 14 21 14 21 14 21 14 21 14 5  99 99 14 99 6  6  6  6  6  6  6  5  99 5  14 21 14 21 14 5  99 99 99 99 6  99 99 99 5  21 14 21 6  6  14 21 14 21 14 21 99 6  6   
99 99 99 99 99 99 99 99 99 99 99 5  14 21 14 21 14 21 14 21 14 21 14 21 14 21 14 21 14 21 14 21 14 21 5  99 99 21 6  21 14 21 14 21 14 21 5  5  5  21 14 21 14 21 5  99 99 99 99 99 99 99 99 6  99 21 14 21 14 21 14 21 14 21   
99 99 99 99 99 99 99 99 99 99 99 6  21 14 21 14 21 5  21 14 21 14 21 14 21 14 21 14 21 14 21 14 21 14 6  99 99 14 21 14 21 14 21 14 21 14 6  6  6  14 21 14 21 14 5  99 5  6  99 99 99 99 99 99 99 14 21 14 21 14 21 14 99 99 5  6  
99 99 99 99 99 99 99 99 99 99 99 99 6  6  6  6  6  5  14 21 14 21 5  5  14 21 14 21 14 21 14 21 14 21 99 99 99 99 5  21 14 21 14 21 14 21 14 21 14 21 14 21 14 21 5  99 5  99 99 99 99 99 99 99 99 99 14 21 14 99 99 99 99 99 6   
99 99 99 99 99 99 99 99 99 99 99 99 99 99 99 99 99 5  21 14 21 14 5  5  21 14 21 14 21 14 21 14 21 14 5  99 6  99 5  14 21 14 21 14 21 14 21 14 21 14 21 14 21 14 5  99 6  99 99 99 99 99 99 99 99 6  99 99 99 99 99 6  6 
99 99 99 99 99 99 99 99 99 99 99 99 6  6  99 6  99 5  14 21 14 21 5  5  14 21 14 21 14 21 14 21 14 21 5  99 99 99 6  21 14 21 14 21 14 21 5  99 5  21 14 21 14 21 6  99 99 99 99 99 99 99 99 99 99 99 5  6   
99 99 99 99 99 99 99 99 99 99 99 99 99 99 99 99 99 6  6  6  6  6  5  5  21 14 21 14 21 14 21 14 21 14 5  99 5  99 99 6  6  5  5  5  5  6  6  99 5  14 21 14 21 14 99 99 99 99 99 99 99 99 99 99 99 99 6 
99 99 99 99 99 99 99 99 99 99 99 99 99 99 99 99 99 99 99 99 99 99 6  5  14 21 14 21 14 21 14 21 14 21 5  99 6  99 99 99 99 6  6  6  6  99 99 99 5  21 14 21 14 21 5  
99 99 99 99 99 99 99 99 99 99 99 99 99 99 99 99 99 6  99 99 99 6  99 5  5  6  6  5  5  5  5  6  6  6  6  99 99 99 99 99 99 99 99 99 99 99 99 99 6  14 21 14 21 14 5  
99 99 99 99 99 99 99 99 99 99 99 99 99 99 99 99 99 99 99 99 99 99 99 6  6  99 99 6  6  6  6  99 99 99 99 99 99 99 99 6  6  99 99 99 99 99 99 5  99 6  6  5  5  5  6 
99 99 99 99 99 99 99 99 99 99 99 99 99 99 99 99 99 99 99 99 99 99 99 99 99 99 99 99 99 99 99 99 6  99 99 99 99 99 99 99 99 99 99 99 99 99 99 6  99 99 99 6  6  6  
99 99 99 99 99 99 99 99 99 99 99 99 99 99 99 99 99 99 99 99 99 99 99 6  6  
99 99 99 

# Items Layer
99 99 99 99 99 99 99 99 99 99 99 99 99 99 99 99 99 99 99 99 99 99 99 99 99 99 99 99 99 99 99 99 99 99 99 99 99 99 99 99 99 99 99 99 99 99 99 99 99 99 99 99 99 99 99 99 99 99 99 99 99 99 99 99 99 99 99 99 99 99 99 99 99 99 99 99 99 99 99
99 99 99 99 99 99 99 99 99 99 99 99 99 99 99 99 99 99 99 99 99 99 99 99 99 99 99 99 99 99 99 99 99 99 99 99 99 99 99 99 99 99 99 99 99 99 99 99 99 99 99 99 99 99 99 99 99 99 99 99 99 99 99 99 99 99 99 99 99 99 99 99 99 99 99 99 99 99 99
99 99 99 99 99 99 99 99 99 99 99 99 99 99 99 99 99 99 99 99 99 99 99 99 99 99 99 99 99 99 99 99 99 99 99 99 99 99 99 99 99 99 99 99 99 99 99 99 99 99 99 99 99 99 99 99 99 99 99 99 99 99 99 99 99 99 99 99 99 99 99 99 99 99 99 99 99 99 99
99 99 99 99 99 99 99 99 99 99 99 99 99 99 99 99 99 99 99 99 99 99 99 99 99 99 99 99 99 99 99 99 99 99 99 99 99 99 99 99 99 99 99 99 99 99 99 99 99 99 99 99 99 99 99 99 99 99 99 99 99 99 99 99 99 99 99 99 99 99 99 99 99 99 99 99 99 99 99
99 99 99 99 99 99 99 99 99 99 99 99 99 99 99 99 99 99 99 99 99 99 99 99 99 99 99 99 99 99 99 99 99 99 99 99 99 99 99 99 99 99 99 99 99 99 99 99 99 99 99 99 99 99 99 99 99 99 99 99 99 99 99 99 99 99 99 99 99 99 99 99 99 99 99 99 99 99 99
99 99 99 99 99 99 99 99 99 99 99 99 99 99 99 99 99 99 99 99 99 99 99 99 99 99 99 99 99 99 99 99 99 99 99 99 99 99 99 99 99 99 99 99 99 99 99 99 99 99 99 99 99 99 99 99 99 99 99 99 99 99 99 99 99 99 99 99 99 99 99 99 99 99 99 99 99 99 99
99 99 99 99 99 99 99 99 99 99 99 99 99 99 99 99 99 99 99 99 99 99 99 99 99 99 99 99 99 99 99 99 99 99 99 99 99 99 99 99 99 99 99 99 99 99 99 99 99 99 99 99 99 99 99 99 99 99 99 99 99 99 99 99 99 99 99 99 99 99 99 99 99 99 99 99 99 99 99
99 99 99 99 99 99 99 99 99 99 99 99 99 99 99 99 99 99 99 99 99 99 99 99 99 99 99 99 99 99 99 99 99 99 99 99 99 99 99 99 99 99 99 99 99 99 99 99 99 99 99 99 99 99 99 99 99 99 99 99 99 99 99 99 99 99 99 99 99 99 99 99 99 99 99 99 99 99 99
99 99 99 99 99 99 99 99 99 99 99 99 99 99 99 99 99 99 99 99 99 99 99 99 99 99 99 99 99 99 99 99 99 99 99 99 99 99 99 99 99 99 99 99 99 99 99 99 99 99 99 99 99 99 99 99 99 99 99 99 99 99 99 99 99 99 99 99 99 99 99 99 99 99 99 99 99 99 99
99 99 99 99 99 99 99 99 99 99 99 99 99 99 99 99 99 99 99 99 99 99 99 99 99 99 99 99 99 99 99 99 99 99 99 99 99 99 99 99 99 99 99 99 99 99 99 99 99 99 99 99 99 99 99 99 99 99 99 99 99 99 99 99 99 99 99 99 99 99 99 99 99 99 99 99 99 99 99
99 99 99 99 99 99 99 99 99 99 99 99 99 99 99 99 99 99 99 99 99 99 99 99 99 99 99 99 99 99 99 99 99 99 99 99 99 99 99 99 99 99 99 99 99 99 99 99 99 99 99 99 99 99 99 99 99 99 99 99 99 99 99 99 99 99 99 99 99 99 99 99 99 99 99 99 99 99 99
99 99 99 99 99 99 99 99 99 99 99 99 99 99 99 99 99 99 99 99 99 99 99 99 99 99 99 99 99 99 99 99 99 99 99 99 99 99 99 99 99 99 99 99 99 99 99 99 99 99 99 99 99 99 99 99 99 99 99 99 99 99 99 99 99 99 99 99 99 99 99 99 99 99 99 99 99 99 99
99 99 99 99 99 99 99 99 99 99 99 99 99 99 99 99 99 99 99 99 99 99 99 99 99 99 99 99 99 99 99 99 99 99 99 99 99 99 99 99 99 99 99 99 99 99 99 99 99 99 99 99 99 99 99 99 99 99 99 99 99 99 99 99 99 99 99 99 99 99 99 99 99 99 99 99 99 99 99
99 99 99 99 99 99 99 99 99 99 99 99 99 99 99 99 99 99 99 99 99 99 99 99 99 99 99 99 99 99 99 99 99 99 99 99 99 99 99 99 99 99 99 99 99 99 99 99 99 99 99 99 99 99 99 99 99 99 99 99 99 99 99 99 99 99 99 99 99 99 99 99 99 99 99 99 99 99 99
99 99 99 99 51 99 99 99 99 99 99 99 99 99 99 99 99 99 99 99 99 99 99 99 99 99 99 99 99 99 99 99 99 99 99 99 99 99 99 99 99 99 99 99 99 99 99 99 99 99 99 99 99 99 99 99 99 99 99 99 99 99 99 99 99 99 99 99 99 99 99 99 99 99 99 99 99 99 99
99 99 99 99 99 99 99 99 99 99 99 99 99 99 99 99 99 99 99 99 99 99 99 99 99 99 99 99 99 99 99 99 99 99 99 99 99 99 99 99 99 99 99 99 99 99 99 99 99 99 99 99 99 99 99 99 99 99 99 99 99 99 99 99 99 99 99 99 99 99 99 99 99 99 99 99 99 99 99
99 99 99 99 99 99 99 99 99 99 99 99 99 99 99 99 99 99 99 99 99 99 99 99 99 99 99 99 99 99 99 99 99 99 99 99 99 99 99 99 99 99 99 99 99 99 99 99 99 99 99 99 99 99 99 99 99 99 99 99 99 99 99 99 99 99 99 99 99 99 99 99 99 99 99 99 99 99 99
99 99 99 99 99 99 99 99 99 99 99 99 99 99 99 99 99 99 99 99 99 99 99 99 99 99 99 99 99 99 99 99 99 99 99 99 99 99 99 99 99 99 99 99 99 99 99 99 99 99 99 99 99 99 99 99 99 99 99 99 99 99 99 99 99 99 99 99 99 99 99 99 99 99 99 99 99 99 99
99 99 99 99 99 99 99 99 99 99 99 99 99 99 99 99 99 99 99 99 99 99 99 99 99 99 99 99 99 99 99 99 99 99 99 99 99 99 99 99 99 99 99 99 99 99 99 99 99 99 99 99 99 99 99 99 99 99 99 99 99 99 99 99 99 99 99 99 99 99 99 99 99 99 99 99 99 99 99
99 99 99 99 99 99 99 99 99 99 99 99 99 99 99 99 99 99 99 99 99 99 99 99 99 99 99 99 99 99 99 99 99 99 99 99 99 99 99 99 99 99 99 99 99 99 99 99 99 99 99 99 99 99 99 99 99 99 99 99 99 99 99 99 99 99 99 99 99 99 99 99 99 99 99 99 99 99 99
99 99 99 99 99 99 99 99 99 99 99 99 99 99 99 99 99 99 99 99 99 99 99 99 99 99 99 99 99 99 99 99 99 99 99 99 99 99 99 99 99 99 99 99 99 99 99 99 99 99 99 99 99 99 99 99 99 99 99 99 99 99 99 99 99 99 99 99 99 99 99 99 99 99 99 99 99 99 99
99 99 99 99 99 99 99 99 99 99 99 99 99 99 99 99 99 99 99 99 99 99 99 99 99 99 99 99 99 99 99 99 99 99 99 99 99 99 99 99 99 99 99 99 99 99 99 99 99 99 99 99 99 99 99 99 99 99 99 99 99 99 99 99 99 99 99 99 99 99 99 99 99 99 99 99 99 99 99
99 99 99 99 99 99 99 99 99 99 99 99 99 99 99 99 99 99 99 99 99 99 99 99 99 99 99 99 99 99 99 99 99 99 99 99 99 99 99 99 99 99 99 99 99 99 99 99 99 99 99 99 99 99 99 99 99 99 99 99 99 99 99 99 99 99 99 99 99 99 99 99 99 99 99 99 99 99 99
99 99 99 99 99 99 99 99 99 99 99 99 99 99 99 99 99 99 99 99 99 99 99 99 99 99 99 99 99 99 99 99 99 99 99 99 99 99 99 99 99 99 99 99 99 99 99 99 99 99 99 99 99 99 99 99 99 99 99 99 99 99 99 99 99 99 99 99 99 99 99 99 99 99 99 99 99 99 99
99 99 99 99 99 99 99 99 99 99 99 99 99 99 99 99 99 99 99 99 99 99 99 99 99 99 99 99 99 99 99 99 99 99 99 99 99 99 99 99 99 99 99 99 99 99 99 99 99 99 99 99 99 99 99 99 99 99 99 99 99 99 99 99 99 99 99 99 99 99 99 99 99 99 99 99 99 99 99
99 99 99 99 99 99 99 99 99 99 99 99 99 99 99 99 99 99 99 99 99 99 99 99 99 99 99 99 99 99 99 99 99 99 99 99 99 99 99 99 99 99 99 99 99 99 99 99 99 99 99 99 99 99 99 99 99 99 99 99 99 99 99 99 99 99 99 99 99 99 99 99 99 99 99 99 99 99 99
99 99 99 99 99 99 99 99 99 99 99 99 99 99 99 99 99 99 99 99 99 99 99 99 99 99 99 99 99 99 99 99 99 99 99 99 99 99 99 99 99 99 99 99 99 99 99 99 99 99 99 99 99 99 99 99 99 99 99 99 99 99 99 99 99 99 99 99 99 99 99 99 99 99 99 99 99 99 99
99 99 99 99 99 99 99 99 99 99 99 99 99 99 99 99 99 99 99 99 99 99 99 99 99 99 99 99 99 99 99 99 99 99 99 99 99 99 99 99 99 99 99 99 99 99 99 99 99 99 99 99 99 99 99 99 99 99 99 99 99 99 99 99 99 99 99 99 99 99 99 99 99 99 99 99 99 99 99
99 99 99 99 99 99 99 99 99 99 99 99 99 99 99 99 99 99 99 99 99 99 99 99 99 99 99 99 99 99 99 99 99 99 99 99 99 99 99 99 99 99 99 99 99 99 99 99 99 99 99 99 99 99 99 99 99 99 99 99 99 99 99 99 99 99 99 99 99 99 99 99 99 99 99 99 99 99 99
99 99 99 99 99 99 99 99 99 99 99 99 99 99 99 99 99 99 99 99 99 99 99 99 99 99 99 99 99 99 99 99 99 99 99 99 99 99 99 99 99 99 99 99 99 99 99 99 99 99 99 99 99 99 99 99 99 99 99 99 99 99 99 99 99 99 99 99 99 99 99 99 99 99 99 99 99 99 99
99 99 99 99 99 99 99 99 99 99 99 99 99 99 99 99 99 99 99 99 99 99 99 99 99 99 99 99 99 99 99 99 99 99 99 99 99 99 99 99 99 99 99 99 99 99 99 99 99 99 99 99 99 99 99 99 99 99 99 99 99 99 99 99 99 99 99 99 99 99 99 99 99 99 99 99 99 99 99
99 99 99 99 99 99 99 99 99 99 99 99 99 99 99 99 99 99 99 99 99 99 99 99 99 99 99 99 99 99 99 99 99 99 99 99 99 99 99 99 99 99 99 99 99 99 99 99 99 99 99 99 99 99 99 99 99 99 99 99 99 99 99 99 99 99 99 99 99 99 99 99 99 99 99 99 99 99 99

# Entity Layer
0  0  0  0  0  0  0  0  0  0  0  0  0  0  0  0  0  0  0  0  0  0  0  0  0  0  0  0  0  0  0  0  0  0  0  0  0  0  0  0  0 
0  0  0  0  0  0  0  0  0  0  0  0  0  0  0  0  0  0  0  0  0  0  0  0  0  0  0  0  0  0  0  0  0  0  0  0  0  0  0  0  0 
0  0  0  0  0  0  0  0  0  0  0  0  0  0  0  0  0  0  0  0  0  0  0  0  0  0  0  0  0  0  0  0  0  0  0  0  0  0  0  0  0 
0  0  0  0  0  0  0  0  0  0  0  0  0  0  0  0  0  0  0  0  0  0  0  0  0  0  0  0  0  0  0  0  0  0  0  0  0  0  0  0  0 
0  0  0  0  0  0  0  0  0  0  0  0  0  0  0  0  0  0  0  0  0  0  0  0  0  0  0  0  0  0  0  0  0  0  0  0  0  0  0  0  0 
0  0  0  0  0  0  0  0  0  0  0  0  0  0  0  0  0  0  0  0  0  0  0  0  0  0  0  0  0  0  0  0  0  0  0  0  0  0  0  0  0 
0  0  0  0  0  0  0  0  0  0  0  0  0  0  0  0  0  0  0  0  0  0  0  0  0  0  0  0  0  0  0  0  0  0  0  0  0  0  0  0  0 
0  0  0  0  0  0  0  0  0  0  0  0  0  0  0  0  0  0  0  0  0  0  0  0  0  0  0  0  0  0  0  0  0  0  0  0  0  0  0  0  0 
0  0  0  0  0  0  0  0  0  0  0  0  0  0  0  0  0  0  0  0  0  0  0  0  0  0  0  0  0  0  0  0  0  0  0  0  0  0  0  0  0 
0  0  0  0  0  0  0  0  0  0  0  0  0  0  0  3  0  0  0  0  0  0  0  0  0  0  0  0  0  0  0  0  0  0  0  0  0  0  0  0  0 
0  0  0  0  0  0  0  0  0  0  0  0  0  0  0  0  0  0  0  0  0  0  0  0  0  0  0  0  0  0  0  0  0  0  0  0  0  0  0  0  0 
0  0  0  0  0  0  0  4  0  0  0  0  0  0  0  3  0  0  0  0  0  0  0  0  0  0  0  0  0  0  0  0  0  0  0  0  0  0  0  0  0 
0  0  0  0  0  0  0  0  0  0  0  0  0  0  0  0  0  0  0  0  0  0  0  0  0  0  0  0  0  0  0  0  0  0  0  0  0  0  0  0  0 
0  0  0  0  0  0  0  0  0  0  0  0  0  0  0  0  0  0  0  0  0  0  0  0  0  0  0  0  0  0  0  0  0  0  0  0  0  0  0  0  0 
0  0  0  0  0  0  1  0  0  0  0  0  0  0  0  0  0  0  0  0  0  0  0  0  0  0  0  0  0  0  0  0  0  0  0  0  0  0  0  0  0 
0  0  0  0  0  0  0  0  0  0  0  0  0  0  0  0  0  0  0  0  0  0  0  0  0  0  0  0  0  0  0  0  0  0  0  0  0  0  0  0  0 
0  0  0  0  0  0  0  0  0  0  0  0  0  0  0  0  0  0  0  0  0  0  0  0  0  0  0  0  0  0  0  0  0  0  0  0  0  0  0  0  0 
0  0  0  0  0  0  0  0  0  0  0  0  0  0  0  0  0  0  0  0  0  0  0  0  0  0  0  0  0  0  0  0  0  0  0  0  0  0  0  0  0 
0  0  0  0  0  0  0  0  0  0  0  0  0  0  0  0  0  0  0  0  0  0  0  0  0  0  0  0  0  0  0  0  0  0  0  0  0  0  0  0  0 
0  0  0  0  0  0  0  0  0  0  0  0  0  0  0  0  0  0  0  0  0  0  0  0  0  0  0  0  0  0  0  0  0  0  0  0  0  0  0  0  0 
0  0  0  0  0  0  0  0  0  0  0  0  0  0  0  0  0  0  0  0  0  0  0  0  0  0  0  0  0  0  0  0  0  0  0  0  0  0  0  0  0 
0  0  0  0  0  0  0  0  0  0  0  0  0  0  0  0  0  0  0  0  0  0  0  0  0  0  0  0  0  0  0  0  0  0  0  0  0  0  0  0  0 
0  0  0  0  0  0  0  0  0  0  0  0  0  0  0  0  0  0  0  0  0  0  0  0  0  0  0  0  0  0  0  0  0  0  0  0  0  0  0  0  0 