99 99 99 99 99 99 99 99 99 99 99 99 99 99 99 99 99 99 99 99 99 99 99 99 99 99 99 99 99 99 99 99 99 99 99 99 99 99 99 99 99 5  6  6  99 6  6 
99 99 99 99 99 99 99 99 99 99 99 99 99 99 99 99 99 99 99 99 99 99 99 99 99 99 99 99 99 99 99 99 99 99 99 99 6  99 99 99 99 5  21 14 21 14 21 5  99 99 6
99 99 99 99 99 99 99 99 99 99 99 99 99 99 99 99 99 99 99 99 99 99 99 99 99 99 99 99 99 99 99 99 99 99 99 99 99 99 99 99 6  5  14 21 14 21 14 5  
99 99 99 99 99 99 99 99 99 99 99 99 99 99 99 99 99 99 99 99 99 99 99 99 99 99 99 99 99 99 99 99 99 99 99 99 99 99 6  99 99 5  21 14 21 14 21 5  5  99 99 99 99 5  5  5  5  99 99 99 6
99 99 99 99 99 99 99 99 99 99 99 99 6  99 99 99 99 99 99 99 99 99 99 99 99 99 99 99 99 99 99 99 99 99 99 99 99 99 99 99 5  5  14 21 14 21 14 6  6  6  6  6  6  6  6  6  6  6  5 
99 99 99 99 99 99 99 99 99 99 99 99 99 99 99 99 99 99 99 99 99 6  5  99 99 99 99 99 99 99 99 99 99 6  6  99 99 99 99 99 6  5  21 14 21 14 21 14 21 14 21 14 21 14 21 14 21 14 5  
99 99 99 99 99 99 6  6  99 99 99 5  5  5  99 99 99 99 99 99 99 99 6  99 99 99 99 99 99 6  99 99 99 99 99 99 99 99 99 99 99 5  14 21 14 21 14 21 14 21 14 21 14 21 14 21 14 21 5  5
99 99 99 99 99 99 99 99 99 99 5  6  6  6  6  5  99 6  99 99 99 99 99 99 99 99 99 99 99 99 99 99 5  5  5  5  5  5  99 99 99 6  21 14 21 14 21 6  6  5  21 14 21 14 21 14 21 14 5  5  99 5 
99 99 99 6  5  99 99 5  6  5  5  21 14 21 14 5  99 99 99 99 5  5  99 99 99 99 6  99 5  6  6  6  6  6  6  6  6  6  6  99 99 99 6  6  14 21 5  99 99 5  14 21 14 21 14 21 14 21 5  6  99 6 
99 99 5  99 6  6  6  6  99 5  5  14 21 14 21 5  99 5  5  6  6  6  6  6  6  5  99 99 5  14 21 14 21 14 21 14 21 14 21 5  99 99 99 99 21 14 5  99 99 5  21 14 21 14 21 14 21 14 5  99 99 99 99 99 99 99 99 6  5
99 6  5  21 14 21 14 21 14 6  6  21 14 21 14 6  6  6  6  21 14 21 14 21 14 6  6  99 6  21 14 21 14 21 14 21 14 21 14 5  99 99 5  5  14 21 5  5  99 5  5  6  6  5  14 21 14 5  6  99 99 99 99 99 99 99 99 99 6  99 99 99 6 
99 99 5  14 21 14 21 14 21 14 21 14 21 14 21 14 21 14 21 14 21 14 21 14 21 14 21 14 21 14 21 14 21 14 21 14 21 14 21 5  99 6  6  6  21 14 6  6  5  5  6  99 99 5  21 14 21 5  99 99 99 5 
99 99 6  21 14 21 14 21 14 21 14 21 14 21 14 21 14 21 14 21 14 21 14 21 14 21 14 21 14 21 14 21 14 21 14 21 14 21 14 5  5  21 14 21 14 21 14 21 5  5  99 99 99 5  14 21 14 5  99 99 99 5  99 99 99 99 99 99 99 99 6  99 99 99 6
99 99 99 14 21 14 21 14 21 5  5  14 21 14 21 6  6  99 5  14 21 14 21 14 21 5  5  6  6  14 21 14 21 14 21 14 21 14 21 5  5  14 21 14 21 14 21 14 5  6  99 99 99 5  21 14 21 5  5  99 99 6  99 99 5  6  99 99 99 99 21 14 21 14 99
99 6  99 21 14 21 14 21 14 5  5  5  5  5  5  99 99 99 5  21 14 21 14 21 14 5  6  99 99 21 14 21 14 21 14 21 14 21 14 5  5  21 14 21 14 21 14 21 5  99 99 5  99 6  14 21 14 5  5  99 99 99 99 99 6  21 14 21 14 21 14 21 14 21 99 
99 99 99 14 21 14 21 14 21 5  5  5  6  6  6  6  6  99 6  14 21 14 21 14 21 6  99 99 5  14 21 14 21 14 21 14 21 14 21 5  5  14 21 14 21 14 21 14 6  99 99 6  99 99 21 14 21 5  5  99 99 99 5  14 21 14 21 14 21 14 21 14 21 14 21 99
99 99 5  21 14 21 14 21 14 6  6  6  14 21 14 21 14 99 99 21 14 21 14 21 14 99 99 99 6  6  6  6  6  6  99 6  6  21 6  6  5  21 14 21 14 21 14 21 99 99 99 99 99 5  14 21 14 5  5  99 99 99 5  21 14 21 5  5  14 21 14 21 14 21 14 99  
6  99 5  14 21 14 21 14 21 14 21 14 21 14 21 14 21 6  99 14 21 14 21 14 21 5  99 99 99 99 99 99 99 99 99 99 99 14 99 99 5  14 21 14 21 14 21 14 5  99 99 99 5  5  21 14 21 5  5  99 99 5  5  14 21 14 6  6  21 14 21 14 5  5  21 99 6  
99 99 6  21 14 21 14 21 14 21 14 21 14 21 14 21 14 21 14 21 14 21 14 21 14 5  99 99 5  6  99 99 6  6  99 99 99 21 99 99 5  21 14 21 14 21 14 21 5  5  99 99 5  5  14 21 14 6  6  6  6  6  6  21 14 21 14 21 14 21 14 21 6  6  14 21 99
99 99 99 14 21 14 21 14 21 6  6  5  21 14 21 14 21 14 21 14 21 14 21 14 21 5  99 99 6  99 99 99 99 99 99 99 21 14 21 99 6  14 21 14 21 14 21 14 5  5  99 99 6  5  21 14 21 14 21 14 21 14 21 14 21 14 21 14 21 14 21 14 21 14 21 14 99
99 99 99 6  6  99 6  6  6  99 99 5  14 21 14 21 14 5  5  21 14 21 14 21 14 5  99 5  99 99 99 99 5  99 99 99 14 21 14 21 14 21 14 21 14 21 14 21 5  6  99 99 99 5  14 21 14 21 14 21 14 21 14 21 14 21 14 21 14 21 14 21 14 21 14 21 99
99 99 99 99 99 99 99 99 99 99 99 5  21 14 21 14 21 5  5  5  5  5  5  5  6  6  6  6  99 99 6  6  6  99 99 99 21 14 21 99 99 14 21 14 21 14 21 14 5  99 99 99 99 6  21 14 21 14 21 14 21 14 21 14 21 14 21 14 21 14 21 14 21 14 21 14 99 6   
99 99 99 99 6  99 99 6  5  99 99 5  14 21 14 21 14 5  5  5  5  5  5  5  14 21 14 21 14 21 14 21 14 21 99 99 99 21 99 99 6  21 14 21 14 21 14 21 5  99 99 99 99 99 6  6  6  5  5  5  5  6  5  21 14 21 14 21 14 21 14 21 14 21 14 99
99 99 99 99 99 99 99 99 6  99 99 5  21 14 21 14 21 5  6  6  6  6  5  5  21 14 21 14 21 14 21 14 21 14 21 14 21 14 99 99 99 5  5  6  6  5  5  6  5  5  5  5  99 99 99 99 99 6  6  6  6  99 5  14 21 14 21 14 21 14 21 14 21 14 21 99 
99 99 99 99 99 99 99 99 99 99 6  5  14 21 14 21 14 6  14 21 14 21 5  5  14 21 14 21 14 21 14 21 14 21 5  99 99 21 99 99 99 5  5  99 99 5  5  99 5  6  6  6  6  6  99 99 99 99 99 99 99 99 6  21 14 21 14 5  5  21 14 21 14 21 14 99 5  
99 99 99 6  99 99 99 99 99 99 99 5  21 14 21 14 21 14 21 14 21 14 6  6  21 14 21 14 21 14 21 14 21 14 5  99 99 14 99 6  6  6  6  6  6  6  5  99 5  14 21 14 21 14 5  99 99 99 99 6  99 99 99 5  21 14 21 6  6  14 21 14 21 14 21 99 6  6   
99 99 99 99 99 99 99 99 99 99 99 5  14 21 14 21 14 21 14 21 14 21 14 21 14 21 14 21 14 21 14 21 14 21 5  99 99 21 6  21 14 21 14 21 14 21 5  5  5  21 14 21 14 21 5  99 99 99 99 99 99 99 99 6  99 21 14 21 14 21 14 21 14 21 99  
99 99 99 99 99 99 99 99 99 99 99 6  21 14 21 14 21 5  21 14 21 14 21 14 21 14 21 14 21 14 21 14 21 14 6  99 99 14 21 14 21 14 21 14 21 14 6  6  6  14 21 14 21 14 5  99 5  6  99 99 99 99 99 99 99 14 21 14 21 14 21 14 99 99 5  6  
99 99 99 99 99 99 99 99 99 99 99 99 6  6  6  6  6  5  14 21 14 21 5  5  14 21 14 21 14 21 14 21 14 21 99 99 99 99 5  21 14 21 14 21 14 21 14 21 14 21 14 21 14 21 5  99 5  99 99 99 99 99 99 99 99 99 14 21 14 99 99 99 99 99 6   
99 99 99 99 99 99 99 99 99 99 99 99 99 99 99 99 99 5  21 14 21 14 5  5  21 14 21 14 21 14 21 14 21 14 5  99 6  99 5  14 21 14 21 14 21 14 21 14 21 14 21 14 21 14 5  99 6  99 99 99 99 99 99 99 99 6  99 99 99 99 99 6  6 
99 99 99 99 99 99 99 99 99 99 99 99 6  6  99 6  99 5  14 21 14 21 5  5  14 21 14 21 14 21 14 21 14 21 5  99 99 99 6  21 14 21 14 21 14 21 5  99 5  21 14 21 14 21 6  99 99 99 99 99 99 99 99 99 99 99 5  6   
99 99 99 99 99 99 99 99 99 99 99 99 99 99 99 99 99 6  6  6  6  6  5  5  21 14 21 14 21 14 21 14 21 14 5  99 5  99 99 6  6  5  5  5  5  6  6  99 5  14 21 14 21 14 99 99 99 99 99 99 99 99 99 99 99 99 6 
99 99 99 99 99 99 99 99 99 99 99 99 99 99 99 99 99 99 99 99 99 99 6  5  14 21 14 21 14 21 14 21 14 21 5  99 6  99 99 99 99 6  6  6  6  99 99 99 5  21 14 21 14 21 5  
99 99 99 99 99 99 99 99 99 99 99 99 99 99 99 99 99 6  99 99 99 6  99 5  5  6  6  5  5  5  5  6  6  6  6  99 99 99 99 99 99 99 99 99 99 99 99 99 6  14 21 14 21 14 5  
99 99 99 99 99 99 99 99 99 99 99 99 99 99 99 99 99 99 99 99 99 99 99 6  6  99 99 6  6  6  6  99 99 99 99 99 99 99 99 6  6  99 99 99 99 99 99 5  99 6  6  5  5  5  6 
99 99 99 99 99 99 99 99 99 99 99 99 99 99 99 99 99 99 99 99 99 99 99 99 99 99 99 99 99 99 99 99 6  99 99 99 99 99 99 99 99 99 99 99 99 99 99 6  99 99 99 6  6  6  
99 99 99 99 99 99 99 99 99 99 99 99 99 99 99 99 99 99 99 99 99 99 99 6  6  
99 99 99 

# Items Layer
99 99 99 99 99 99 99 99 99 99 99 99 99 99 99 99 99 99 99 99 99 99 99 99 99 99 99 99 99 99 99 99 99 99 99 99 99 99 99 99 99 99 99 99 99 99 99
99 99 99 99 99 99 99 99 99 99 99 99 99 99 99 99 99 99 99 99 99 99 99 99 99 99 99 99 99 99 99 99 99 99 99 99 99 99 99 99 99 99 99 99 99 99 99 99 99 99 99
99 99 99 99 99 99 99 99 99 99 99 99 99 99 99 99 99 99 99 99 99 99 99 99 99 99 99 99 99 99 99 99 99 99 99 99 99 99 99 99 99 99 99 99 99 43 99 99 
99 99 99 99 99 99 99 99 99 99 99 99 99 99 99 99 99 99 99 99 99 99 99 99 99 99 99 99 99 99 99 99 99 99 99 99 99 99 99 99 99 99 99 68 99 41 99 99 99 99 99 99 99 99 99 99 99 99 99 99 99
99 99 99 99 99 99 99 99 99 99 99 99 99 99 99 99 99 99 99 99 99 99 99 99 99 99 99 99 99 99 99 99 99 99 99 99 99 99 99 99 99 99 99 42 99 99 99 99 99 99 99 99 99 99 99 99 99 99 99
99 99 99 99 99 99 99 99 99 99 99 99 99 99 99 99 99 99 99 99 99 99 99 99 99 99 99 99 99 99 99 99 99 99 99 99 99 99 99 99 99 99 99 99 99 99 99 99 99 99 99 99 99 99 99 99 26 27 99 
99 99 99 99 99 99 99 99 99 99 99 99 99 99 99 99 99 99 99 99 99 99 99 99 99 99 99 99 99 99 99 99 99 99 99 99 99 99 99 99 99 99 99 99 70 70 99 99 99 99 99 40 99 99 99 99 99 28 99 
99 99 99 99 99 99 99 99 99 99 99 99 99 99 99 99 99 99 99 99 99 99 99 99 99 99 99 99 99 99 99 99 99 99 99 99 99 99 99 99 99 99 99 99 99 99 52 99 99 99 99 99 38 99 99 99 99 99 99 99 99 99
99 99 99 99 99 99 99 99 99 99 99 99 99 99 28 99 99 99 99 99 99 99 99 99 99 99 99 99 99 99 99 99 99 99 99 99 99 99 99 99 99 99 99 99 99 99 99 99 99 99 99 52 67 66 99 99 99 99 99 99 99 99
99 99 99 99 99 99 99 99 99 99 99 32 99 99 99 99 99 99 99 99 99 99 99 99 99 99 99 99 99 99 99 99 99 99 99 99 99 99 99 99 99 99 99 99 99 99 99 99 99 99 99 99 99 99 99 99 99 99 99 99 99 99 99 99 99 99 99 99 
99 99 99 33 99 99 52 69 99 99 99 99 99 99 99 99 99 99 99 99 29 99 99 99 99 99 99 99 99 99 99 99 99 99 99 99 34 99 99 99 99 99 99 99 99 99 99 99 99 99 99 99 99 99 99 99 99 99 99 99 99 99 99 99 99 99 99 99 99 99 99 99 99
99 99 99 99 99 99 99 99 99 99 99 99 99 99 99 99 99 99 99 99 99 99 99 38 99 99 99 99 99 99 99 99 68 69 53 99 99 32 99 99 99 99 99 99 99 99 99 99 99 99 99 99 99 99 43 99 99 99 99 99 99 99
99 99 99 99 99 99 99 99 99 99 99 99 99 42 99 99 99 99 99 99 99 99 99 99 99 99 99 99 99 99 99 99 99 99 99 99 99 99 99 99 99 99 99 99 99 99 99 99 99 99 99 99 99 99 99 99 99 99 99 99 99 99 99 99 99 99 99 99 99 99 99 99 99 99 99
99 99 99 99 99 99 99 99 99 99 99 99 99 99 52 99 99 99 99 99 99 68 99 99 99 99 99 99 99 99 99 43 99 99 99 99 66 99 99 99 99 99 28 99 99 99 99 99 99 99 99 99 99 99 34 99 99 99 99 99 99 99 99 99 99 99 99 99 99 99 99 99 99 99 
99 99 99 99 51 99 99 99 99 99 99 99 99 99 99 99 99 99 99 99 99 47 99 99 99 99 99 99 99 99 99 99 99 41 99 99 67 99 43 99 99 99 68 67 99 69 99 99 99 99 99 99 99 99 99 99 48 99 99 99 99 99 99 99 99 99 99 99 99 99 99 99 99 99  
99 99 99 99 46 99 99 99 99 99 99 99 99 99 99 99 99 99 99 99 99 99 42 99 99 99 99 99 99 49 99 99 99 99 99 99 99 99 99 99 99 99 99 99 99 99 34 32 99 99 99 99 99 99 26 99 99 99 99 99 99 99 99 99 99 99 99 99 99 99 99 99 99 99 99 
99 99 99 70 99 99 99 99 99 99 99 99 99 99 99 66 67 99 99 99 99 99 99 99 99 99 99 99 99 99 99 99 99 99 99 99 99 99 99 99 99 99 49 99 99 99 99 66 99 99 99 99 99 99 99 99 32 99 99 99 99 99 99 99 99 99 99 99 99 99 99 99 99 99 99   
99 99 99 99 99 99 99 34 99 99 99 49 99 99 99 99 99 99 99 99 99 99 99 99 99 99 99 99 99 99 99 99 99 99 99 99 99 99 99 99 99 99 99 50 99 45 99 99 99 99 99 99 99 99 99 99 99 99 99 99 99 99 99 99 99 99 99 99 99 99 99 99 99 99 99 99 99 
99 99 99 99 41 99 99 99 99 99 99 99 99 99 99 99 99 99 99 99 99 99 68 99 99 99 99 99 99 99 99 99 99 99 99 99 99 99 99 99 99 99 99 99 99 99 99 99 99 99 99 99 99 99 99 40 99 99 99 99 99 99 99 46 99 99 99 99 99 99 99 99 99 99 99  
99 99 99 99 99 99 99 99 33 99 99 99 99 99 99 99 99 99 99 99 49 99 70 66 99 99 99 99 99 99 99 99 99 99 99 99 45 99 99 99 99 99 99 66 67 70 99 99 99 99 99 99 99 99 41 99 99 99 99 47 99 99 46 99 99 99 99 99 99 99 99 99 99 99 99  
99 99 99 99 99 99 99 99 99 99 99 99 99 99 99 99 99 99 99 99 99 99 99 99 99 99 99 99 99 99 99 99 99 99 99 99 99 64 99 99 99 99 99 42 99 99 99 99 99 99 99 99 99 99 99 99 99 46 99 99 99 47 99 99 99 99 99 99 99 99 99 99 99 99 99 
99 99 99 99 99 99 99 99 99 99 99 99 69 99 99 99 99 99 99 99 99 99 99 99 99 99 99 99 99 99 99 99 99 99 99 99 99 47 34 99 99 99 99 99 99 99 38 99 99 99 99 99 99 99 99 99 99 99 99 99 45 99 45 99 47 99 99 99 99 99 99 99 99 99 99 99 99 99  
99 99 99 99 99 99 99 99 99 99 99 99 99 99 99 99 99 99 99 99 99 99 99 99 99 40 99 99 99 99 99 99 99 99 99 99 99 99 99 99 99 26 99 99 99 99 99 99 99 99 99 99 99 99 99 99 99 99 99 99 99 99 99 99 99 99 99 99 99 99 99 99 99 99 99  
99 99 99 99 99 99 99 99 99 99 99 99 99 99 99 50 99 99 99 99 99 99 99 99 99 99 99 99 99 99 43 50 99 99 99 99 99 99 99 99 99 99 99 99 99 99 99 99 99 99 99 99 99 99 99 99 99 99 99 99 99 99 99 45 99 99 99 99 99 99 99 99 99 99 99  
99 99 99 99 99 99 99 99 99 99 99 99 66 99 99 99 99 99 99 99 99 99 99 99 99 99 68 99 99 99 99 99 99 99 99 99 99 99 99 99 99 99 99 99 99 99 99 99 99 99 99 99 99 99 99 99 99 99 99 99 99 99 99 99 99 99 99 99 99 99 99 99 99 99 99 99 99 
99 99 99 99 99 99 99 99 99 99 99 99 99 99 99 99 99 99 99 52 99 99 99 99 99 99 68 99 99 99 67 99 99 99 99 99 99 99 99 99 99 99 99 99 99 99 99 99 99 99 99 99 64 99 99 99 99 99 99 99 99 99 99 99 99 99 99 99 99 99 99 99 99 99 99 99 99 99  
99 99 99 99 99 99 99 99 99 99 99 99 68 99 99 99 99 99 99 99 99 99 99 99 99 99 99 34 99 99 99 99 99 99 99 99 99 99 99 99 33 45 99 99 99 99 99 99 99 99 99 99 99 99 99 99 99 99 99 99 99 99 99 99 99 99 99 99 99 99 99 99 99 99   
99 99 99 99 99 99 99 99 99 99 99 99 68 99 99 99 99 99 99 99 99 99 99 99 99 99 69 99 99 99 68 99 99 99 99 99 99 99 99 99 99 99 99 99 34 99 99 99 99 99 99 99 99 99 99 99 99 99 99 99 99 99 99 99 99 99 99 99 99 99 99 99 99 99 99 99 
99 99 99 99 99 99 99 99 99 99 99 99 99 99 99 99 99 99 99 99 69 99 99 99 99 99 68 99 99 99 99 99 99 99 99 99 99 99 99 99 99 99 99 99 99 99 99 99 99 99 67 99 99 99 99 99 99 99 99 99 99 99 99 99 99 99 99 99 99 99 99 99 99 99 99  
99 99 99 99 99 99 99 99 99 99 99 99 99 99 99 99 99 99 50 99 99 99 99 99 99 99 99 99 99 99 66 99 99 99 99 99 99 99 99 99 99 99 52 68 99 99 99 99 99 99 99 99 70 99 99 99 99 99 99 99 99 99 99 99 99 99 99 99 99 99 99 99 99
99 99 99 99 99 99 99 99 99 99 99 99 99 99 99 99 99 99 99 99 99 99 99 99 99 99 99 99 99 99 68 99 99 99 99 99 99 99 99 99 99 99 99 99 99 99 99 99 99 99 99 99 70 99 99 99 99 99 99 99 99 99 99 99 99 99 99 99  
99 99 99 99 99 99 99 99 99 99 99 99 99 99 99 99 99 99 99 99 99 99 99 99 99 49 99 99 99 99 99 99 52 42 99 99 99 99 99 99 99 99 99 99 99 99 99 99 99 99 99 99 99 99 99 99 99 99 99 99 99 99 99 99 99 99 99
99 99 99 99 99 99 99 99 99 99 99 99 99 99 99 99 99 99 99 99 99 99 99 99 99 99 99 99 99 99 99 99 99 99 99 99 99 99 99 99 99 99 99 99 99 99 99 99 99 99 28 99 99 99 99 
99 99 99 99 99 99 99 99 99 99 99 99 99 99 99 99 99 99 99 99 99 99 99 99 99 99 99 99 99 99 99 99 99 99 99 99 99 99 99 99 99 99 99 99 99 99 99 99 99 99 99 99 99 99 99 
99 99 99 99 99 99 99 99 99 99 99 99 99 99 99 99 99 99 99 99 99 99 99 99 99 99 99 99 99 99 99 99 99 99 99 99 99 99 99 99 99 99 99 99 99 99 99 99 99 99 99 99 99 99 99
99 99 99 99 99 99 99 99 99 99 99 99 99 99 99 99 99 99 99 99 99 99 99 99 99 99 99 99 99 99 99 99 99 99 99 99 99 99 99 99 99 99 99 99 99 99 99 99 99 99 99 99 99 99 
99 99 99 99 99 99 99 99 99 99 99 99 99 99 99 99 99 99 99 99 99 99 99 99 99 
99 99 99 

# Entity Layer
0  0  0  0  0  0  0  0  0  0  0  0  0  0  0  0  0  0  0  0  0  0  0  0  0  0  0  0  0  0  0  0  0  0  0  0  0  0  0  0  0  0  0  0  0  0  0  0  0  0  0  0  0  0  0  0  0  0  0  0  0  0  0  0  0  0  0  0  0  0  0  0  0  0  0  0  0  0  0  0  0  0 
0  0  0  0  0  0  0  0  0  0  0  0  0  0  0  0  0  0  0  0  0  0  0  0  0  0  0  0  0  0  0  0  0  0  0  0  0  0  0  0  0  0  0  0  0  0  0  0  0  0  0  0  0  0  0  0  0  0  0  0  0  0  0  0  0  0  0  0  0  0  0  0  0  0  0  0  0  0  0  0  0  0 
0  0  0  0  0  0  0  0  0  0  0  0  0  0  0  0  0  0  0  0  0  0  0  0  0  0  0  0  0  0  0  0  0  0  0  0  0  0  0  0  0  0  0  0  0  0  0  0  0  0  0  0  0  0  0  0  0  0  0  0  0  0  0  0  0  0  0  0  0  0  0  0  0  0  0  0  0  0  0  0  0  0 
0  0  0  0  0  0  0  0  0  0  0  0  0  0  0  0  0  0  0  0  0  0  0  0  0  0  0  0  0  0  0  0  0  0  0  0  0  0  0  0  0  0  0  0  0  0  0  0  0  0  0  0  0  0  0  0  0  0  0  0  0  0  0  0  0  0  0  0  0  0  0  0  0  0  0  0  0  0  0  0  0  0 
0  0  0  0  0  0  0  0  0  0  0  0  0  0  0  0  0  0  0  0  0  0  0  0  0  0  0  0  0  0  0  0  0  0  0  0  0  0  0  0  0  0  0  0  0  0  0  0  0  0  0  0  0  0  0  0  0  0  0  0  0  0  0  0  0  0  0  0  0  0  0  0  0  0  0  0  0  0  0  0  0  0 
0  0  0  0  0  0  0  0  0  0  0  0  0  0  0  0  0  0  0  0  0  0  0  0  0  0  0  0  0  0  0  0  0  0  0  0  0  0  0  0  0  0  0  0  0  0  0  0  0  0  0  0  0  0  0  0  0  0  0  0  0  0  0  0  0  0  0  0  0  0  0  0  0  0  0  0  0  0  0  0  0  0 
0  0  0  0  0  0  0  0  0  0  0  0  0  0  0  0  0  0  0  0  0  0  0  0  0  0  0  0  0  0  0  0  0  0  0  0  0  0  0  0  0  0  0  0  0  0  0  0  0  0  0  0  0  0  0  0  0  0  0  0  0  0  0  0  0  0  0  0  0  0  0  0  0  0  0  0  0  0  0  0  0  0 
0  0  0  0  0  0  0  0  0  0  0  0  0  0  0  0  0  0  0  0  0  0  0  0  0  0  0  0  0  0  0  0  0  0  0  0  0  0  0  0  0  0  0  0  0  0  0  0  0  0  0  0  0  0  0  0  0  0  0  0  0  0  0  0  0  0  0  0  0  0  0  0  0  0  0  0  0  0  0  0  0  0 
0  0  0  0  0  0  0  0  0  0  0  0  0  0  0  0  0  0  0  0  0  0  0  0  0  0  0  0  0  0  0  0  0  0  0  0  0  0  0  0  0  0  0  0  0  0  0  0  0  0  0  0  0  0  0  0  0  0  0  0  0  0  0  0  0  0  0  0  0  0  0  0  0  0  0  0  0  0  0  0  0  0 
0  0  0  0  0  0  0  0  0  0  0  0  0  0  0  3  0  0  0  0  0  0  0  0  0  0  0  0  0  0  0  0  0  0  0  0  0  0  0  0  0  0  0  0  0  0  0  0  0  0  0  0  0  0  0  0  0  0  0  0  0  0  0  0  0  0  0  0  0  0  0  0  0  0  0  0  0  0  0  0  0  0 
0  0  0  0  0  0  0  0  0  0  0  0  0  0  0  0  0  0  0  0  0  0  0  0  0  0  0  0  0  0  0  0  0  0  0  0  0  0  0  0  0  0  0  0  0  0  0  0  0  0  0  0  0  0  0  0  0  0  0  0  0  0  0  0  0  0  0  0  0  0  0  0  0  0  0  0  0  0  0  0  0  0 
0  0  0  0  0  0  0  4  0  0  0  0  0  0  0  3  0  0  0  0  0  0  0  0  0  0  0  0  0  0  0  0  0  0  0  0  0  0  0  0  0  0  0  0  0  0  0  0  0  0  0  0  0  0  0  0  0  0  0  0  0  0  0  0  0  0  0  0  0  0  0  0  0  0  0  0  0  0  0  0  0  0 
0  0  0  0  0  0  0  0  0  0  0  0  0  0  0  0  0  0  0  0  0  0  0  0  0  0  0  0  0  0  0  0  0  0  0  0  0  0  0  0  0  0  0  0  0  0  0  0  0  0  0  0  0  0  0  0  0  0  0  0  0  0  0  0  0  0  0  0  0  0  0  0  0  0  0  0  0  0  0  0  0  0 
0  0  0  0  0  0  0  0  0  0  0  0  0  0  0  0  0  0  0  0  0  0  0  0  0  0  0  0  0  0  0  0  0  0  0  0  0  0  0  0  0  0  0  0  0  0  0  0  0  0  0  0  0  0  0  0  0  0  0  0  0  0  0  0  0  0  0  0  0  0  0  0  0  0  0  0  0  0  0  0  0  0 
0  0  0  0  0  0  T  0  0  0  0  0  0  0  0  0  0  0  0  0  0  0  0  0  0  0  0  0  0  0  0  0  0  0  0  0  0  0  0  0  0  0  0  0  0  0  0  0  0  0  0  0  0  0  0  0  0  0  0  0  0  0  0  0  0  0  0  0  0  0  0  0  0  0  0  0  0  0  0  0  0  0 
0  0  0  0  0  0  0  0  0  0  0  0  0  0  0  0  0  0  0  0  0  0  0  0  0  0  0  0  0  0  0  0  0  0  0  0  0  0  0  0  0  0  0  0  0  0  0  0  0  0  0  0  0  0  0  0  0  0  0  0  0  0  0  0  0  0  0  0  0  0  9  0  0  0  0  0  0  0  0  0  0  0 
0  0  0  0  0  0  0  0  0  0  0  0  0  0  0  0  0  0  0  0  0  0  0  0  0  0  0  0  0  0  0  0  0  0  0  0  0  0  0  0  0  0  0  0  0  0  0  0  0  0  0  0  0  0  0  0  0  0  0  0  0  0  0  0  0  0  0  0  0  0  0  0  0  0  0  0  0  0  0  0  0  0 
0  0  0  0  0  0  0  0  0  0  0  0  0  0  0  0  0  0  0  0  0  0  0  0  0  0  0  0  0  0  0  0  0  0  0  0  0  0  0  0  0  0  0  0  0  0  0  0  0  0  0  0  0  0  0  0  0  0  0  0  0  0  0  0  0  0  0  0  0  0  0  0  0  0  0  0  0  0  0  0  0  0 
0  0  0  0  0  0  0  0  0  0  0  0  0  0  0  0  0  0  0  0  0  0  0  0  0  0  0  0  0  0  0  0  0  0  0  0  0  0  0  0  0  0  0  0  0  0  0  0  0  0  0  0  0  0  0  0  0  0  0  0  0  0  0  0  0  0  0  0  0  0  0  0  0  0  0  0  0  0  0  0  0  0 
0  0  0  0  0  0  0  0  0  0  0  0  0  0  0  0  0  0  0  0  0  0  0  0  0  0  0  0  0  0  0  0  0  0  0  0  0  0  0  0  0  0  0  0  0  0  0  0  0  0  0  0  0  0  0  0  0  0  0  0  1  0  0  0  0  0  0  0  0  0  0  0  0  0  0  0  0  0  0  0  0  0 
0  0  0  0  0  0  0  0  0  0  0  0  0  0  0  0  0  0  0  0  0  0  0  0  0  0  0  0  0  0  0  0  0  0  0  0  0  0  0  0  0  0  0  0  0  0  0  0  0  0  0  0  0  0  0  0  0  0  0  0  0  0  0  0  0  0  0  0  0  0  0  0  0  0  0  0  0  0  0  0  0  0 
0  0  0  0  0  0  0  0  0  0  0  0  0  0  0  0  0  0  0  0  0  0  0  0  0  0  0  0  0  0  0  0  0  0  0  0  0  0  0  0  0  0  0  0  0  0  0  0  0  0  0  0  0  0  0  0  0  0  0  0  0  0  0  0  0  0  0  0  0  0  0  0  0  0  0  0  0  0  0  0  0  0 
0  0  0  0  0  0  0  0  0  0  0  0  0  0  0  0  0  0  0  0  0  0  0  0  0  0  0  0  0  0  0  0  0  0  0  0  0  0  0  0  0  0  0  0  0  0  0  0  0  0  0  0  0  0  0  0  0  0  0  0  0  0  0  0  0  0  0  0  0  0  0  0  0  0  0  0  0  0  0  0  0  0 