5  5  5  5  5  5  5  5  5  5  5  5  5  5  5  5  5  5  5  5  5  99 99 99 99 99 99 99 99 99 99 99 99 99 99 99 99 99 99 99 99
5  5  5  5  5  5  5  5  5  5  5  5  5  5  5  5  5  5  5  5  6  99 99 99 99 99 99 99 99 99 99 99 99 99 99 99 99 99 99 99 99
5  5  5  5  5  5  5  5  5  5  5  5  5  5  5  5  5  5  5  5  99 99 99 99 99 99 99 99 99 99 99 99 99 99 99 99 99 99 99 99 99
5  5  5  5  5  5  5  5  5  5  5  5  5  5  5  5  5  5  5  6  99 99 99 99 99 99 99 99 99 99 99 99 99 99 99 99 99 99 99 99 99
5  5  5  5  5  5  6  6  6  6  6  6  6  6  6  6  5  5  6  99 99 99 99 99 99 99 99 99 99 99 99 99 99 99 99 99 99 99 99 99 99
5  5  5  5  5  5  14 21 14 21 14 21 14 21 14 21 5  6  99 6  99 99 99 99 99 99 99 99 99 99 99 99 99 99 99 99 99 99 99 99 99
5  5  5  5  5  5  21 14 21 14 21 14 21 14 21 14 5  99 99 99 14 99 99 99 99 99 99 99 99 99 99 99 99 99 99 99 99 99 99 99 99
5  5  5  5  5  5  14 21 14 21 14 21 14 21 14 21 5  6  99 99 99 99 99 99 99 21 99 99 99 99 99 99 99 99 99 99 99 99 99 99 99
5  5  5  5  5  5  21 14 21 14 21 14 21 14 21 14 5  99 6  99 6  99 21 14 21 99 99 99 99 99 99 99 99 99 99 99 99 99 99 99 99
5  5  5  5  5  5  5  5  5  5  5  5  14 21 14 21 5  5  99 99 99 99 14 21 14 99 99 99 99 99 99 99 99 99 99 99 99 99 99 99 99
5  5  5  5  5  5  5  6  5  5  5  5  21 14 21 14 5  5  99 6  21 99 21 14 21 99 99 5  99 99 99 99 99 99 99 6  5  99 99 99 99
6  6  6  6  6  6  6  99 6  6  5  5  14 21 14 21 5  5  99 99 99 99 99 21 99 99 99 6  6  99 99 99 6  6  99 99 6  99 99 99 99
99 99 99 99 99 99 99 99 99 99 5  5  21 14 21 14 5  5  5  99 5  99 99 14 99 14 99 99 99 99 6  6  99 99 99 99 99 99 99 99 99 
99 99 99 99 99 99 6  99 99 99 6  5  14 21 14 21 6  6  6  6  6  6  6  21 6  6  6  6  99 21 14 21 14 99 99 99 99 99 99 99 99
99 99 99 99 99 99 99 99 99 6  99 5  21 14 21 14 21 14 21 14 21 14 21 14 21 14 21 14 21 14 21 14 21 6  99 99 99 99 99 99 99
99 99 99 99 99 99 99 99 99 99 6  5  14 21 14 21 14 21 14 21 14 21 14 21 14 21 14 21 14 21 14 21 14 21 99 6  99 99 99 99 99
99 99 99 99 99 99 99 99 6  99 99 5  21 14 21 14 21 14 21 14 21 14 21 14 21 14 21 14 21 14 21 14 21 14 5  99 99 99 99 99 99
99 99 99 99 99 99 99 99 99 99 99 6  14 21 14 21 14 21 14 21 14 21 14 21 14 21 14 21 14 21 14 21 14 21 6  99 99 99 99 99 99
99 99 99 99 99 99 99 99 99 6  99 99 6  5  5  5  6  6  5  99 6  6  5  5  5  6  99 99 5  14 21 14 21 99 99 5  6  6  99 99 99 
99 99 99 99 99 99 99 99 99 99 99 99 99 6  6  6  99 99 6  99 99 99 6  6  6  99 99 99 6  6  99 6  99 99 99 6  99 99 99 99 99
99 99 99 99 99 99 99 99 99 6  99 99 99 99 99 99 99 99 99 99 99 99 99 99 99 99 99 99 99 99 99 99 99 6  99 99 99 99 99 99 99
99 99 99 99 99 99 99 99 99 99 99 99 99 99 99 99 99 99 99 6  99 99 99 99 99 6  99 99 99 99 99 99 99 99 99 99 99 99 99 99 99


# Items Layer
99 99 99 99 99 99 99 99 99 99 99 99 99 99 99 99 99 99 99 99 99 99 99 99 99 99 99 99 99 99 99 99 99 99 99 99 99 99 99 99 99
99 99 99 99 99 99 99 99 99 99 99 99 99 99 99 99 99 99 99 99 99 99 99 99 99 99 99 99 99 99 99 99 99 99 99 99 99 99 99 99 99
99 99 99 99 99 99 99 99 99 99 99 99 99 99 99 99 99 99 99 99 99 99 99 99 99 99 99 99 99 99 99 99 99 99 99 99 99 99 99 99 99
99 99 99 99 99 99 99 99 99 99 99 99 99 99 99 99 99 99 99 99 99 99 99 99 99 99 99 99 99 99 99 99 99 99 99 99 99 99 99 99 99
99 99 99 99 99 99 99 99 99 60 99 99 99 99 99 99 99 99 99 99 99 99 99 99 99 99 99 99 99 99 99 99 99 99 99 99 99 99 99 99 99
99 99 99 99 99 99 66 99 99 99 99 99 99 99 30 31 99 99 99 99 99 99 99 99 99 99 99 99 99 99 99 99 99 99 99 99 99 99 99 99 99
99 99 99 99 99 99 69 99 99 99 99 99 22 99 99 99 99 99 99 99 99 99 99 99 99 99 99 99 99 99 99 99 99 99 99 99 99 99 99 99 99
99 99 99 99 99 99 99 99 99 99 99 99 99 99 99 99 99 99 99 99 99 99 99 99 99 99 99 99 99 99 99 99 99 99 99 99 99 99 99 99 99
99 99 99 99 99 99 68 99 99 99 99 99 99 99 99 99 99 99 99 99 99 99 99 99 99 99 99 99 99 99 99 99 99 99 99 99 99 99 99 99 99
99 99 99 99 99 99 99 99 99 99 99 99 29 99 99 99 99 99 99 99 99 99 99 64 99 99 99 99 99 99 99 99 99 99 99 99 99 99 99 99 99
99 99 99 99 99 99 99 99 99 99 99 99 99 99 99 99 99 99 99 99 99 99 99 99 99 99 99 99 99 99 99 99 99 99 99 99 99 99 99 99 99
99 99 99 99 99 99 99 99 99 99 99 99 99 99 99 99 99 99 99 99 99 99 99 99 99 99 99 99 99 99 99 99 99 99 99 99 99 99 99 99 99
99 99 99 99 99 99 99 99 99 99 99 99 99 99 99 99 99 99 99 99 99 99 99 99 99 99 99 99 99 99 99 99 99 99 99 99 99 99 99 99 99
99 99 99 99 99 99 99 99 99 99 99 99 99 99 99 99 99 99 99 99 99 99 99 62 99 99 99 99 99 99 99 99 99 99 99 99 99 99 99 99 99
99 99 99 99 99 99 99 99 99 99 99 99 99 99 99 99 99 99 99 99 99 99 99 99 69 99 99 99 99 99 99 99 99 99 99 99 99 99 99 99 99
99 99 99 99 99 99 99 99 99 99 99 99 99 99 99 99 99 99 99 99 99 99 99 99 99 99 99 99 99 99 99 99 99 99 99 99 99 99 99 99 99
99 99 99 99 99 99 99 99 99 99 99 99 67 99 99 99 99 99 99 99 99 99 99 99 99 99 99 99 99 99 99 99 63 99 99 99 99 99 99 99 99
99 99 99 99 99 99 99 99 99 99 99 99 70 65 99 99 99 99 99 99 99 99 99 70 99 99 99 99 99 99 99 99 99 68 99 99 99 99 99 99 99
99 99 99 99 99 99 99 99 99 99 99 99 99 99 99 99 99 99 99 99 99 99 99 99 99 99 99 99 99 99 99 99 99 99 99 99 99 99 99 99 99
99 99 99 99 99 99 99 99 99 99 99 99 99 99 99 99 99 99 99 99 99 99 99 99 99 99 99 99 99 99 99 99 99 99 99 99 99 99 99 99 99
99 99 99 99 99 99 99 99 99 99 99 99 99 99 99 99 99 99 99 99 99 99 99 99 99 99 99 99 99 99 99 99 99 99 99 99 99 99 99 99 99
99 99 99 99 99 99 99 99 99 99 99 99 99 99 99 99 99 99 99 99 99 99 99 99 99 99 99 99 99 99 99 99 99 99 99 99 99 99 99 99 99
99 99 99 99 99 99 99 99 99 99 99 99 99 99 99 99 99 99 99 99 99 99 99 99 99 99 99 99 99 99 99 99 99 99 99 99 99 99 99 99 99

# Entity Layer
0  0  0  0  0  0  0  0  0  0  0  0  0  0  0  0  0  0  0  0  0  0  0  0  0  0  0  0  0  0  0  0  0  0  0  0  0  0  0  0  0 
0  0  0  0  0  0  0  0  0  0  0  0  0  0  0  0  0  0  0  0  0  0  0  0  0  0  0  0  0  0  0  0  0  0  0  0  0  0  0  0  0 
0  0  0  0  0  0  0  0  0  0  0  0  0  0  0  0  0  0  0  0  0  0  0  0  0  0  0  0  0  0  0  0  0  0  0  0  0  0  0  0  0 
0  0  0  0  0  0  0  0  0  0  0  0  0  0  0  0  0  0  0  0  0  0  0  0  0  0  0  0  0  0  0  0  0  0  0  0  0  0  0  0  0 
0  0  0  0  0  0  0  0  0  0  0  0  0  0  0  0  0  0  0  0  0  0  0  0  0  0  0  0  0  0  0  0  0  0  0  0  0  0  0  0  0 
0  0  0  0  0  0  0  0  0  1  0  0  0  0  0  0  0  0  0  0  0  0  0  0  0  0  0  0  0  0  0  0  0  0  0  0  0  0  0  0  0 
0  0  0  0  0  0  0  0  0  0  0  0  0  0  0  0  0  0  0  0  0  0  0  0  0  0  0  0  0  0  0  0  0  0  0  0  0  0  0  0  0 
0  0  0  0  0  0  0  0  0  0  0  0  0  0  0  0  0  0  0  0  0  0  0  0  0  0  0  0  0  0  0  0  0  0  0  0  0  0  0  0  0 
0  0  0  0  0  0  0  0  0  0  0  0  0  0  0  0  0  0  0  0  0  0  0  0  0  0  0  0  0  0  0  0  0  0  0  0  0  0  0  0  0 
0  0  0  0  0  0  0  0  0  0  0  0  0  0  0  3  0  0  0  0  0  0  0  0  0  0  0  0  0  0  0  0  0  0  0  0  0  0  0  0  0 
0  0  0  0  0  0  0  0  0  0  0  0  0  0  0  0  0  0  0  0  0  0  0  0  0  0  0  0  0  0  0  0  0  0  0  0  0  0  0  0  0 
0  0  0  0  0  0  0  0  0  0  0  0  0  0  0  3  0  0  0  0  0  0  0  0  0  0  0  0  0  0  0  0  0  0  0  0  0  0  0  0  0 
0  0  0  0  0  0  0  0  0  0  0  0  0  0  0  0  0  0  0  0  0  0  0  0  0  0  0  0  0  0  0  0  0  0  0  0  0  0  0  0  0 
0  0  0  0  0  0  0  0  0  0  0  0  0  0  0  0  0  0  0  0  0  0  0  0  0  0  0  0  0  0  0  0  0  0  0  0  0  0  0  0  0 
0  0  0  0  0  0  0  0  0  0  0  0  0  0  0  0  0  0  0  0  0  0  0  0  0  0  0  0  0  0  0  0  0  0  0  0  0  0  0  0  0 
0  0  0  0  0  0  0  0  0  0  0  0  0  0  0  0  0  0  0  0  0  0  0  0  0  0  0  0  0  0  0  0  0  0  0  0  0  0  0  0  0 
0  0  0  0  0  0  0  0  0  0  0  0  0  0  0  0  0  0  0  0  0  0  0  0  0  0  0  0  0  0  0  0  0  0  0  0  0  0  0  0  0 
0  0  0  0  0  0  0  0  0  0  0  0  0  0  0  0  0  0  0  0  0  0  0  0  0  0  0  0  0  0  0  0  0  0  0  0  0  0  0  0  0 
0  0  0  0  0  0  0  0  0  0  0  0  0  0  0  0  0  0  0  0  0  0  0  0  0  0  0  0  0  0  0  0  0  0  0  0  0  0  0  0  0 
0  0  0  0  0  0  0  0  0  0  0  0  0  0  0  0  0  0  0  0  0  0  0  0  0  0  0  0  0  0  0  0  0  0  0  0  0  0  0  0  0 
0  0  0  0  0  0  0  0  0  0  0  0  0  0  0  0  0  0  0  0  0  0  0  0  0  0  0  0  0  0  0  0  0  0  0  0  0  0  0  0  0 