5  5  5  5  5  5  5  5  5  5  5  5  5  5  5  5  5  5  5  5  5  99 99 99 99 99 99 99 99 99 99 99 99 99 99 99 99 99 99 99 99
5  5  5  5  5  5  5  5  5  5  5  5  5  5  5  5  5  5  5  5  6  99 99 99 99 99 99 99 99 99 99 99 99 99 99 99 99 99 99 99 99
5  5  5  5  5  5  5  5  5  5  5  5  5  5  5  5  5  5  5  5  99 99 99 99 99 99 99 99 99 99 99 99 99 99 99 99 99 99 99 99 99
5  5  5  5  5  5  5  5  5  5  5  5  5  5  5  5  5  5  5  6  99 99 99 99 99 99 99 99 99 99 99 99 99 99 99 99 99 99 99 99 99
5  5  5  5  5  5  6  6  6  72 6  6  6  6  6  6  5  5  6  99 99 99 99 99 99 99 99 99 99 99 99 99 99 99 99 99 99 99 99 99 99
5  5  5  5  5  5  14 21 14 21 14 21 14 21 14 21 5  6  99 6  99 99 99 99 99 99 99 99 99 99 99 99 99 99 99 99 99 99 99 99 99
5  5  5  5  5  5  21 14 21 14 21 14 21 14 21 14 5  99 99 99 14 99 99 99 99 99 99 99 99 99 99 99 99 99 99 99 99 99 99 99 99
5  5  5  5  5  5  14 21 14 21 14 21 14 21 14 21 5  6  99 99 99 99 99 99 99 21 99 99 99 99 99 99 99 99 99 99 99 99 99 99 99
5  5  5  5  5  5  21 14 21 14 21 14 21 14 21 14 5  99 6  99 6  99 21 14 21 99 99 99 99 99 99 99 99 99 99 99 99 99 99 99 99
5  5  5  5  5  5  5  5  5  5  5  5  14 21 14 21 5  5  99 99 99 99 14 21 14 99 99 99 99 99 99 99 99 99 99 99 99 99 99 99 99
5  5  5  5  5  5  5  6  5  5  5  5  21 14 21 14 5  5  99 6  21 99 21 14 21 99 99 5  99 99 99 99 99 99 99 6  5  99 99 99 99
6  6  6  6  6  6  6  99 6  6  5  5  14 21 14 21 5  5  99 99 99 99 99 21 99 99 99 6  6  99 99 99 6  6  99 99 6  99 99 99 99
99 99 99 99 99 99 99 99 99 99 5  5  21 14 21 14 5  5  5  99 5  99 99 14 99 14 99 99 99 99 6  6  99 99 99 99 99 99 99 99 99 
99 99 99 99 99 99 6  99 99 99 6  5  14 21 14 21 6  6  6  6  6  6  6  74 6  6  6  6  99 21 14 21 14 99 99 99 99 99 99 99 99
99 99 99 99 99 99 99 99 99 6  99 5  21 14 21 14 21 14 21 14 21 14 21 14 21 14 21 14 21 14 21 14 21 6  99 99 99 99 99 99 99
99 99 99 99 99 99 99 99 99 99 6  5  14 21 14 21 14 21 14 21 14 21 14 21 14 21 14 21 14 21 14 21 14 21 99 6  99 99 99 99 99
99 99 99 99 99 99 99 99 6  99 99 5  21 14 21 14 21 14 21 14 21 14 21 14 21 14 21 14 21 14 21 14 75 14 5  99 99 99 99 99 99
99 99 99 99 99 99 99 99 99 99 99 6  14 21 14 21 14 21 14 21 14 21 14 21 14 21 14 21 14 21 14 21 14 21 6  99 99 99 99 99 99
99 99 99 99 99 99 99 99 99 6  99 99 6  5  5  5  6  6  5  99 6  6  5  5  5  6  99 99 5  14 21 14 21 99 99 5  6  6  99 99 99 
99 99 99 99 99 99 99 99 99 99 99 99 99 6  6  6  99 99 6  99 99 99 6  6  6  99 99 99 6  6  99 6  99 99 99 6  99 99 99 99 99
99 99 99 99 99 99 99 99 99 6  99 99 99 99 99 99 99 99 99 99 99 99 99 99 99 99 99 99 99 99 99 99 99 6  99 99 99 99 99 99 99
99 99 99 99 99 99 99 99 99 99 99 99 99 99 99 99 99 99 99 6  99 99 99 99 99 6  99 99 99 99 99 99 99 99 99 99 99 99 99 99 99


# Items Layer
1 2 3 54 20 45