5  5  5  5  5  5  5  5  5  5  5  5  5  5  5  5  5
5  5  5  5  5  5  5  5  5  5  5  5  5  5  5  5  5 
5  5  5  5  5  5  5  5  5  5  5  5  5  5  5  5  5
5  5  5  5  5  5  5  5  5  5  5  5  5  5  5  5  5
5  5  5  5  5  5  6  6  6  72 6  6  6  6  6  6  5
5  5  5  5  5  5  14 21 14 21 14 21 14 21 14 21 5
5  5  5  5  5  5  21 14 21 14 21 14 21 14 21 14 5
5  5  5  5  5  5  14 21 14 21 14 21 14 21 14 21 5
5  5  5  5  5  5  21 14 21 14 21 14 21 14 21 14 5
5  5  5  5  5  5  5  5  5  5  5  5  14 21 14 21 5
5  5  5  5  5  5  5  6  5  5  5  5  21 14 21 14 5
6  6  6  6  6  6  6  99 6  6  5  5  14 21 14 21 5
99 99 99 99 99 99 99 99 99 99 5  5  21 14 21 14 5
99 99 99 99 99 99 99 99 99 99 6  5  14 21 14 21 5
99 99 99 99 99 99 99 99 99 6  99 5  21 14 21 14 5