5 6  6  6  72 6  6  5
5 14 21 14 21 14 21 5
5 21 14 21 14 21 14 5 
5 14 21 14 21 14 21 6  6  6  6  6  5
5 21 14 21 14 21 14 21 14 21 14 21 5
5 14 21 14 21 14 21 14 21 14 21 14 5
5 21 14 21 14 21 14 21 14 21 14 21 5
6 6  6  6  6  6  6  6  6  6  6  6  6
