77 77 77 77 77 77 77 77 77 77 77 77 77 77 77 77 77 77 77 77 77 99 99 99 99 99 99 99 99 99 99 99 99 99 99 99 99 99 99 99 99
77 77 77 77 77 77 77 77 77 77 77 77 77 77 77 77 77 77 77 77 78 99 99 99 99 99 99 99 99 99 99 99 99 99 99 99 99 99 99 99 99
77 77 77 77 77 77 77 77 77 77 77 77 77 77 77 77 77 77 77 77 99 99 99 99 99 99 99 99 99 99 99 99 99 99 99 99 99 99 99 99 99
77 77 77 77 77 77 77 77 77 77 77 77 77 77 77 77 77 77 77 78 99 99 99 99 99 99 99 99 99 99 99 99 99 99 99 99 99 99 99 99 99
77 77 77 77 77 77 78 78 78 78 78 78 78 78 78 78 77 77 78 99 99 99 99 99 99 99 99 99 99 99 99 99 99 99 99 99 99 99 99 99 99
77 77 77 77 77 77 72 70 72 70 72 70 72 70 72 70 77 78 99 78 99 99 99 99 99 99 99 99 99 99 99 99 99 99 99 99 99 99 99 99 99
77 77 77 77 77 77 70 72 70 72 70 72 70 72 70 72 77 99 99 99 72 99 99 99 99 99 99 99 99 99 99 99 99 99 99 99 99 99 99 99 99
77 77 77 77 77 77 72 70 72 70 72 70 72 70 72 70 77 78 99 99 99 99 99 99 99 70 99 99 99 99 99 99 99 99 99 99 99 99 99 99 99
77 77 77 77 77 77 70 72 70 72 70 72 70 72 70 72 77 99 78 99 78 99 70 72 70 99 99 99 99 99 99 99 99 99 99 99 99 99 99 99 99
77 77 77 77 77 77 77 77 77 77 77 77 72 70 72 70 77 77 99 99 99 99 72 70 72 99 99 99 99 99 99 99 99 99 99 99 99 99 99 99 99
77 77 77 77 77 77 77 78 77 77 77 77 70 72 70 72 77 77 99 78 70 99 70 72 70 99 99 77 99 99 99 99 99 99 99 78 77 99 99 99 99
78 78 78 78 78 78 78 99 78 78 77 77 72 70 72 70 77 77 99 99 99 99 99 70 99 99 99 78 78 99 99 99 78 78 99 99 78 99 99 99 99
99 99 99 99 99 99 99 99 99 99 77 77 70 72 70 72 77 77 77 99 77 99 99 72 99 72 99 99 99 99 78 78 99 99 99 99 99 99 99 99 99 
99 99 99 99 99 99 78 99 99 99 78 77 72 70 72 70 78 78 78 78 78 78 78 70 78 78 78 78 99 70 72 70 72 99 99 99 99 99 99 99 99
99 99 99 99 99 99 99 99 99 78 99 77 70 72 70 72 70 72 70 72 70 72 70 72 70 72 70 72 70 72 70 72 70 78 99 99 99 99 99 99 99
99 99 99 99 99 99 99 99 99 99 78 77 72 70 72 70 72 70 72 70 72 70 72 70 72 70 72 70 72 70 72 70 72 70 99 78 99 99 99 99 99
99 99 99 99 99 99 99 99 78 99 99 77 70 72 70 72 70 72 70 72 70 72 70 72 70 72 70 72 70 72 70 72 70 72 77 99 99 99 99 99 99
99 99 99 99 99 99 99 99 99 99 99 78 72 70 72 70 72 70 72 70 72 70 72 70 72 70 72 70 72 70 72 70 72 70 78 99 99 99 99 99 99
99 99 99 99 99 99 99 99 99 78 99 99 78 77 77 77 78 78 77 99 78 78 77 77 77 78 99 99 77 72 70 72 70 99 99 77 78 78 99 99 99 
99 99 99 99 99 99 99 99 99 99 99 99 99 78 78 78 99 99 78 99 99 99 78 78 78 99 99 99 78 78 99 78 99 99 99 78 99 99 99 99 99
99 99 99 99 99 99 99 99 99 78 99 99 99 99 99 99 99 99 99 99 99 99 99 99 99 99 99 99 99 99 99 99 99 78 99 99 99 99 99 99 99
99 99 99 99 99 99 99 99 99 99 99 99 99 99 99 99 99 99 99 78 99 99 99 99 99 78 99 99 99 99 99 99 99 99 99 99 99 99 99 99 99


# Items Layer
99 99 99 99 99 99 99 99 99 99 99 99 99 99 99 99 99 99 99 99 99 99 99 99 99 99 99 99 99 99 99 99 99 99 99 99 99 99 99 99 99
99 99 99 99 99 99 99 99 99 99 99 99 99 99 99 99 99 99 99 99 99 99 99 99 99 99 99 99 99 99 99 99 99 99 99 99 99 99 99 99 99
99 99 99 99 99 99 99 99 99 99 99 99 99 99 99 99 99 99 99 99 99 99 99 99 99 99 99 99 99 99 99 99 99 99 99 99 99 99 99 99 99
99 99 99 99 99 99 99 99 99 99 99 99 99 99 99 99 99 99 99 99 99 99 99 99 99 99 99 99 99 99 99 99 99 99 99 99 99 99 99 99 99
99 99 99 99 99 99 99 99 99 60 99 99 99 99 99 99 99 99 99 99 99 99 99 99 99 99 99 99 99 99 99 99 99 99 99 99 99 99 99 99 99
99 99 99 99 99 99 67 99 99 99 99 99 99 99 30 31 99 99 99 99 99 99 99 99 99 99 99 99 99 99 99 99 99 99 99 99 99 99 99 99 99
99 99 99 99 99 99 69 99 99 99 99 99 99 99 99 99 99 99 99 99 99 99 99 99 99 99 99 99 99 99 99 99 99 99 99 99 99 99 99 99 99
99 99 99 99 99 99 99 99 99 99 99 99 99 99 99 99 99 99 99 99 99 99 99 99 99 99 99 99 99 99 99 99 99 99 99 99 99 99 99 99 99
99 99 99 99 99 99 68 22 99 99 99 99 99 99 99 99 99 99 99 99 99 99 99 99 99 99 99 99 99 99 99 99 99 99 99 99 99 99 99 99 99
99 99 99 99 99 99 99 99 99 99 99 99 47 99 99 99 99 99 99 99 99 99 99 64 99 99 99 99 99 99 99 99 99 99 99 99 99 99 99 99 99
99 99 99 99 99 99 99 99 99 99 99 99 99 99 99 99 99 99 99 99 99 99 99 99 99 99 99 99 99 99 99 99 99 99 99 99 99 99 99 99 99
99 99 99 99 99 99 99 99 99 99 99 99 99 99 99 99 99 99 99 99 99 99 99 99 99 99 99 99 99 99 99 99 99 99 99 99 99 99 99 99 99
99 99 99 99 99 99 99 99 99 99 99 99 99 99 99 99 99 99 99 99 99 99 99 99 99 99 99 99 99 99 99 99 99 99 99 99 99 99 99 99 99
99 99 99 99 99 99 99 99 99 99 99 99 99 99 99 99 99 99 99 99 99 99 99 99 99 99 99 99 99 99 99 99 99 99 99 99 99 99 99 99 99
99 99 99 99 99 99 99 99 99 99 99 99 99 99 99 99 99 99 99 99 99 99 99 99 69 99 99 99 99 99 99 99 99 99 99 99 99 99 99 99 99
99 99 99 99 99 99 99 99 99 99 99 99 99 99 99 99 99 99 99 99 99 99 99 99 99 99 99 99 99 99 99 99 99 99 99 99 99 99 99 99 99
99 99 99 99 99 99 99 99 99 99 99 99 67 99 99 99 99 99 99 99 99 99 99 99 99 99 99 99 99 99 99 99 63 99 99 99 99 99 99 99 99
99 99 99 99 99 99 99 99 99 99 99 99 70 67 99 99 99 99 99 99 99 99 99 70 99 99 99 99 99 99 99 99 99 68 99 99 99 99 99 99 99
99 99 99 99 99 99 99 99 99 99 99 99 99 99 99 99 99 99 99 99 99 99 99 99 99 99 99 99 99 99 99 99 99 99 99 99 99 99 99 99 99
99 99 99 99 99 99 99 99 99 99 99 99 99 99 99 99 99 99 99 99 99 99 99 99 99 99 99 99 99 99 99 99 99 99 99 99 99 99 99 99 99
99 99 99 99 99 99 99 99 99 99 99 99 99 99 99 99 99 99 99 99 99 99 99 99 99 99 99 99 99 99 99 99 99 99 99 99 99 99 99 99 99
99 99 99 99 99 99 99 99 99 99 99 99 99 99 99 99 99 99 99 99 99 99 99 99 99 99 99 99 99 99 99 99 99 99 99 99 99 99 99 99 99
99 99 99 99 99 99 99 99 99 99 99 99 99 99 99 99 99 99 99 99 99 99 99 99 99 99 99 99 99 99 99 99 99 99 99 99 99 99 99 99 99

# Entity Layer
0  0  0  0  0  0  0  0  0  0  0  0  0  0  0  0  0  0  0  0  0  0  0  0  0  0  0  0  0  0  0  0  0  0  0  0  0  0  0  0  0 
0  0  0  0  0  0  0  0  0  0  0  0  0  0  0  0  0  0  0  0  0  0  0  0  0  0  0  0  0  0  0  0  0  0  0  0  0  0  0  0  0 
0  0  0  0  0  0  0  0  0  0  0  0  0  0  0  0  0  0  0  0  0  0  0  0  0  0  0  0  0  0  0  0  0  0  0  0  0  0  0  0  0 
0  0  0  0  0  0  0  0  0  0  0  0  0  0  0  0  0  0  0  0  0  0  0  0  0  0  0  0  0  0  0  0  0  0  0  0  0  0  0  0  0 
0  0  0  0  0  0  0  0  0  0  0  0  0  0  0  0  0  0  0  0  0  0  0  0  0  0  0  0  0  0  0  0  0  0  0  0  0  0  0  0  0 
0  0  0  0  0  0  0  0  0  1  0  0  0  0  0  0  0  0  0  0  0  0  0  0  0  0  0  0  0  0  0  0  0  0  0  0  0  0  0  0  0 
0  0  0  0  0  0  0  0  0  0  0  0  0  0  0  0  0  0  0  0  0  0  0  0  0  0  0  0  0  0  0  0  0  0  0  0  0  0  0  0  0 
0  0  0  0  0  0  0  0  0  0  0  0  0  0  0  0  0  0  0  0  0  0  0  0  0  0  0  0  0  0  0  0  0  0  0  0  0  0  0  0  0 
0  0  0  0  0  0  0  0  0  0  0  0  0  0  0  0  0  0  0  0  0  0  0  0  0  0  0  0  0  0  0  0  0  0  0  0  0  0  0  0  0 
0  0  0  0  0  0  0  0  0  0  0  0  0  0  0  0  0  0  0  0  0  0  0  0  0  0  0  0  0  0  0  0  0  0  0  0  0  0  0  0  0 
0  0  0  0  0  0  0  0  0  0  0  0  0  0  0  0  0  0  0  0  0  0  0  0  0  0  0  0  0  0  0  0  0  0  0  0  0  0  0  0  0 
0  0  0  0  0  0  0  0  0  0  0  0  0  0  0  0  0  0  0  0  0  0  0  0  0  0  0  0  0  0  0  0  0  0  0  0  0  0  0  0  0 
0  0  0  0  0  0  0  0  0  0  0  0  0  0  0  0  0  0  0  0  0  0  0  0  0  0  0  0  0  0  0  0  0  0  0  0  0  0  0  0  0 
0  0  0  0  0  0  0  0  0  0  0  0  0  0  0  0  0  0  0  0  0  0  0  0  0  0  0  0  0  0  0  0  0  0  0  0  0  0  0  0  0 
0  0  0  0  0  0  0  0  0  0  0  0  0  0  0  0  0  0  0  0  0  0  0  0  0  0  0  0  0  0  0  0  0  0  0  0  0  0  0  0  0 
0  0  0  0  0  0  0  0  0  0  0  0  0  0  0  0  0  0  0  0  0  0  0  0  0  0  0  0  0  0  0  0  0  0  0  0  0  0  0  0  0 
0  0  0  0  0  0  0  0  0  0  0  0  0  0  0  0  0  0  0  0  0  0  0  0  0  0  0  0  0  0  0  4  0  0  0  0  0  0  0  0  0 
0  0  0  0  0  0  0  0  0  0  0  0  0  0  0  0  0  0  0  0  0  0  0  0  0  0  0  0  0  0  0  0  0  0  0  0  0  0  0  0  0 
0  0  0  0  0  0  0  0  0  0  0  0  0  0  0  0  0  0  0  0  0  0  0  0  0  0  0  0  0  0  0  0  0  0  0  0  0  0  0  0  0 
0  0  0  0  0  0  0  0  0  0  0  0  0  0  0  0  0  0  0  0  0  0  0  0  0  0  0  0  0  0  0  0  0  0  0  0  0  0  0  0  0 
0  0  0  0  0  0  0  0  0  0  0  0  0  0  0  0  0  0  0  0  0  0  0  0  0  0  0  0  0  0  0  0  0  0  0  0  0  0  0  0  0 